Outface	harA
Salvage	ubAra/bacA
Scrunch	cIKa
Shanghai	SafGAI
Shrivel	kumhalA
Shunt	baxala
aberrate	diga
abet	ukasA
abide	saha/raha
abnegate	wyAga/nakAra
abolish	hatA
abort	girA
abrade	Gisa
abrase	Gisa
abridge	GatA
absorb	soKa/sofKa/nigala/le/KapA/apanA
abstract	nikAla
abut	mila
accept	uTA/sakAra/le/laga/kara
access	pahuzca
accommodate	xe/Tahara/milA
accomplish	pA
accord	xe/mila/mila[milAnA]
accost	toka/PazsA
account	samaJa/mAna
accrete	juda
accrue	baDa/mila
accumulate	baDa
accustom	sAXa
ache	warasa
achieve	pA
acknowledge	mAna
acquire	lA
act	xiKa/#kara
adapt	baxala
add	joda/xe/milA/juda/baDA
address	xe/pUCa/lagA/kaha
adhere	cipaka
adjourn	sWAnAnwariwa
adjust	jamA
administer	xe/kara
admit	Tahara
admonish	dAzta
adopt	cuna/apanA/mAna
adorn	sajA
advance	baDA/baDa
advertise	kaha/bawA
advertize	bawA
affect	baxala
affix	lagA/joda
afford	xe/le
aggregate	joda
agitate	ukasA/hilA
aim	lagA/kara
air	sUKa/suKA/bawA
alight	uwara
allay	bu
allocate	bAzta
allot	bANta/xe{bAztanA}
allow	xe/mila
alloy	milA
allure	luBA
ally	milA
alter	baxala
am	hUz
amble	tahala
ameliorate	suXAra
amend	suXAra
amplify	baDA
analyse	manoviSleRaNa
anchor	paDa/kasa/nIMva
angle	biTA
annihilate	mitA
annoy	KIjA/ciDA/sawA
answer	kaha
anticipate	kara
appear	pahuzca/ho
append	joda
applaud	sarAha
apply	lagA
appoint	banA
appreciate	Azka/sarAha
appreciation_verbal	sahAra
apprehend	samaJa/pakadA/pakada
approach	pahuzca/sulaJA/mAzga
arc	vqwwAkAra
argue	Jagada
arise	uTa/nikala
arouse	jagA/uwwejiwa/BadakA
array	sajA
arrest	KIFca/pakada/roka
arrive	pahuzca/A
art	ho
articulate	joda
ascend	caDa/baDa
ascribe	xe
ask	pUCa/mAzga/bulA
aspire	cAha
assert	xiKA
assess	Azka/Afka
assign	xe/bAzta/sOpa
assimilate	apanA
associate	joda/milA/mila/juda[jodanA]
assort	CAzta
assuage	buJA
assume	mAna/samaJa
attach	joda/xe/lagA/apanA
attain	pA/pahuzca
attribut	TaharA
augment	baDA[baDanA]
author	liKa
avoid	tAla/roka/bacA
awake	jAga/jagA
awaken	uTA/jAga/jagA
baa	mimiyAn
babble	badabadA/buxabuxA
back-pedal	mukara
backfire	ulata
bag	mAra/latakA/curA/JUla
bait	sawA/Cede
bake	sefka/suKA/pakA/sezka
balance	wOla/sulaJA/sazBAla/hicakicA
bale	ulIca
balk	TiTaka/ada
ballot	mawaxAna
bang	guzja
bank	roka/moda
baptise	nAmakaraNa
bar	roka
bare	xiKA/xikA
bark	BOfka/garaja/cillA/BUzka/BOzka
bash	Bida
baste	wAga/cupada
bath	nahalA
bathe	Xo/takarA/pOFCa/nahA/nahalA/baha
bathe_verbal	wEra
batter	wod/pIta/mAra/kUta
battle	lada
baulk	TiTaka/ada
bay	ro/BOfka
be	ho/raha/pahuzca/laga/A/bana
beam	xamaka/muskarA/camaka/muskurA
bear	xiKA/xe/uTA/sazBAla/saha/raKa/PElA/PEla/Pala/pahuzcA/muda/mila/le/Kila/kara/Juka/jAna/ho/Dakela
beard	KMica/lalakAra
beat	Xada/woda/pIta/PadaPadA/mAra/jIwa/hilA/harA/barasa/bajA/KataKatA/Xadaka/takarA/wadapA/PeNta
beautify	sajA
beckon	iSArAa
become	ho/bana/Paba
bed	lagA/bETA
bedeck	sajA
bedevil	sawAa
befit	upayukwa
beg	mzAga/Coda/bETa
begrudge	asanwoRa
behave	cala
behold	nihAra
belch	Pefka/dakAra
belie	JuTalA
believe	mAna/samaJa
bellow	dakAra/cIKa
belong	raKa/ho/bETa
belt	mAra
bend	muda/woda/wahiyA/moda/manavA/JukA/Juka/baxala/moda[mudanA]
berate	dAzta/PatakAra
berry	Pala/cuna
best	harA
betray	xiKA
better	suXAra/suXara/suxAra
bicker	Jagada
bid	kaha
bide	raha
bifurcate	xviSAKiwa
bind	bAzXa/lagA/jamA/jama/jakada/garamA/Bara
bite	kAta/woda/pakada/jalA/dasa/daMsa
blarney	KuSAmaxa
blast	barabAxa
blaze	jala/camaka/Badaka
bleach	niKAra
bleat	mimiyA
bleed	nikAla/lUta/ENTa/CAzta
blend	mila/milA/Gula
blight	kumhalA/muraJA
blink	timatimA
blo	suKA
bloat	PulA/sujA/PUla/sUja
block	roka/Kela/joda/banA
bloom	PUla/behawara
blossom	PUla/baDa/Kila/Pala
blot	CIla
blow	uda/woda/udA/PElA/Kila/hAzPa/gazvA/cala/Bara/banA/bajA/baja/baha
blow-out	safgalana/gala/buJA
blow-up	visPota
blubber	bilaKa
blue	udA
blush	SaramA
bluster	XamakA
board	Tahara/caDa
board-at	Bojana
boast	gOrava
bob	uwarA
boggle	TiTaka/JiJaka
boil	ubala/uBAla/ubAla/KOlA/KOla
boil_verbal	ubAla
bolt	Kila
bond	joda
bonk	jixxIa
book	liKa/le
boom	garaja
boost	baDA
boot	tatola
boot_verbal	tatola
bore	UbA/Koxa/kara/Bexa
born	upaja
borrow	le
bounce	uCAla/uCala/hacaka/mAra
bound	uCala/AbaxXa
bow	JukA/Juka
bowl	luDakA/luDaka
braid	bata/gUnWa
brand	xAga
brandish	GumA/PirA/BAzja/lapalapA
brave	lalakAra
brawl	Jagada
bray	refka
break	woda/tUta/sulaJA/rUka/roka/PUta/Poda/Pata/PAda/nikAla/Kola/bigAda/baxala/bawA/A/cala
breast	takarA
breathe	Tahara/PusaPusA/le/kaha/jI/gaMvA/cala/baha
breed	pAlana-poRaNa/pAla/jana/baDA
brew	umada
brighten	camaka
bring	lA/samaJA/pahuzcA/lagA/KIFca/BadakA
broach	Kola
broadcast	PElA/Kela/gA/CiwarA/bOla
broaden	baDA
broil	sezka/sefka
brood	see
brook	saha
browbeat	XamakA
brown	wala/BUna
browse	cara
brunch	branca
brush	Xo/sazvAra/sajA/ragada/pOzCa/Jada
bubble	KaxabaxA
buck	uCala/roka
bucket	nipatA
buckle	Juka/muda
budge	hila/hata/sarakA/saraka/digA/diga/hilA/hatA
budget	bacA
build	nirmANa/kara/jutA/banA/baDA/baDa
bulge	uBara
bulk	xiKa
bull	baDA
bully	XamakA/Jidaka
bum	mAzga
bump	takarA
bunch	wahiyA
bundle	Bara/bAnXa
burble	buxabuxA/badabadA
burden	lAxa
burn	jala/wapA/pakA/kara/JulasA/jalA/galA/banA
burnish	camaka/Jalaka/camakA/mAzja/JalakA
burrow	Koxa
burst	PUta/tUta/Poda/Pata/Kila
bury	xaPanA/samApwae/gAda/dubA/dAla/CupA/CipA
bus	POFCa
butcher	bigAda
butt	takarA
buy	KarIxa
buzz	BanaBanA
bypass	kawarA
cackle	kudakudA/KiKiyA
cajole	PusalA/manA
cake	sana/Dazka/banA
calculate	soca/samaJa/Azka/apanA
call	pukAra/mAzga/lA/kaha/jagA/cillA/cahacahA/bulA/bola/A
call-by	infl
call-down-on	BadakA
call-forth	xiKA
call-out	bulA
calm	XImAe
calve	byA/biyA
camp	Tahara
can	saka/nikAla
cancel	kAta
cannon	takarA
canvass	paraKa
cap	cuna
caper	kUxa
capitulate	Juka
captivate	luBA
capture	pakada/pakadEYa
card	Xuna/Xuana/liKa/joda/cipakA
care	sazBAla/cAha
careen	dagamagA
carpet	dAzta
carry	xe/xarSA/vahana/uTA/upajA/upaja/ukasA/ugA/uCAla/sazBAla/samBAla/raKa/PElA/PEla/pahuzcA/pahuzca/pacA/nikala/niBA/manavA/mAna/le/lAxa/jIwa/ho/gujAra/gA/Do/Dakela/CApa/Capa/calA/cala/bIwA/baxala/baDA/calana
carry-off	jIwa
cart	Do
carve	warASa
cast	Pefka/DAla/dAla/Coda/banA
castigate	PatakAra
cat	uTA/ulatI
catch	pakada/xeKa/WAma/suna/samaJa/roka/PAzsa/PazsA/Pazsa/pA/le/laga/jala/ho/DuzDa/CIna/cala/Bugawa
catch_verbal	pakada
cater	KilA/pilA
cause	xe/ukasA/macA/kara/A
cauterise	xAga
cauterize	xAga
cease	roka
celebrate	manA
cement	joda
centre	lagA
chafe	bajA
chagrin	KIJa/kuDA/KijA
chain	nApa
chair	calA/bETA
chalk	liKa/KiFca/banA
challenge	toka/lalakAra
champ	kuwara
change	pahana/nikAla/dAla/Coda/BunA/baxala
chant	alApa
chap	xarakA/widakA/widaka/Pata/wadaka
char	jalA
charge	TUzsa/sOmpa/mAzga/lagA/Bara/ho
charm	bahakA
chase	woda/pUCa/pA/Kaxeda/BAga/BagA
chastise	dAzta
chatter	katakatA/cahacahA
check	xeKa/roka/jaFca/jAzca
cherish	sazjo/pAla
chew	cabA/soca
chide	dAzta
chill	TaNdA
chink	KanakA/Kanaka
chip	Poda/CIla
chisel	warASa/kAta
chitter	cahaka
choose	cuna/cAzta/cAha
churn	maWa
circle	Guma/Gera
circulate	PEla/GUma/Beja/PElA
circumscribe	KIFca
cite	bulavA
civilize	suXAra
claim	le
clamour	cillA
clamp	kasa/jakada
clang	JanaJanA
clank	JanaJanA
clash	takarA/ulaJa/muTaBeda/lada
clasp	bAzXa
class	samaJa
claw	KaroFca
clean	Xo/pOFCa/nikAla
cleanse	Xo
clear	xe/uwAra/sAPa/nipatA/nikAla/kamA/hatA/cukA/clear/Beja/beca/bawA/banA/hata
clear-up	sulaJA
cleave	mAna
clench	jakada
climb	caDa/uga/pahuzca/pahana/jA/dAla/climba/caDA/baDa
clink	JanaJanA
clip	CAzta/joda
clock	xiKA/mAra/liKa
clog	roka
close	pUrA/monxa/lipata/Gera/DAfka/Bara
cloud	ulaJA
club	mila
cluck	kutakutA
clutch	pakada
coarsen	BArI
coast	Pisala/calA
coat	powa/pahanA/lagA/lepa
coax	manA
cock	kara
coddle	usana
coherent	sambaxXa
coil	lapeta/moda
coin	raca/Koja/kamA/banA/gaDa
collapse	gira/simata
collar	pakada
collate	milA
collect	le/lA/batora/mila/lejA
collide	takkara/takarA
collude	sAzTa-gAzTa
colour	rafga
comb	nikAla/Koja
combat	lada
combine	milA/le/joda/Gola/mila[milAnA]
come	A/uga/pajuzca/pahuzca/pahuMca/pada/nikala/mila/laga/ho
come-down	gira
come-in	A{anxara}
command	xe/xarSA/pA/niyaNtraNa/mAzga/le
commemorate	manA
commend	sOmpa/siPAriSa
commit	liKa/kara/Beja
communicate	kaha/PElA/pahuzcA/bawalA/jawA
complete	banA
complicate	ulaJA
compose	raca/liKa/banA/banAa
compound	nipatA/milA/banA/baDA
comprehend	samaJa
compress	xabA
conceal	CipA
concede	mAna
conceive	soca
conciliate	milA/manA
concoct	gaDa/raca
conduct	calA
confess	mAna
confide	sOmpa/bawA
conflate	milA
conform	mAna
confuse	milA
connect	joda/satA/milA/laga/juda
conquer	jIwa
consent	mAna
consider	soca/samaJa/mAna
consign	Beja
consist	ho
console	sAnwvanAe
consolidate	kara
constitute	banA/ho
construct	banA/raca/KIFca
consult	xeKa{puswaka}
consume	KA/jalA
contain	roka/le/ho/Gera/atA/WAma
continue	raKa/ho
contort	ENTa
contract	TaharA/sikuda/sikoda/mudakA/le/karAra/kara/ho/dAla/bazXa/pakada
contrive	banA
control	sulaJA
convene	batura/mila
convert	baxala
convey	pahuzcA
convulse	maroda
cook	ubAla/pakA/banA
cop	pakada/laga/curA
cope	samhAla/pUrAa
cordon-off	GerA
corn	Bigo
corner	PasA
corrade	Gisa
correct	suXAra/suXara/SoXa
corrode	Kuraca
cost	pada
cough	xe/KAzsa/KaKAra
could	saka/{praSnavAcaka}kyA/sakA
count	soca/gina
countersign	prawihaswAkRara
couple	joda/milA
course	cala/baha
court	uTA/riJA/bulA/bahalA/cAha
cover	liKa/Gera/Dazka/CupA/caDa/biKera/bETa/baDA/baDa/DAzka/Cipa
cow	XamakA/kAta/darA
crack	woda/tUta/sulaJA/PUta/Poda/pIta/Pata/maroda/mAra/kara/kadaka/catakA/cataka/cala/citaka/citakA/kaha
crackle	cidacidA/citaka/Badaka
cram	TUzsa/TUMsa/rata/Gota
cramp	jakada/roka
crash	uwAra/uwara/takarA/Pefka/mAra/kadaka/GusA/gujAra/gira/gadagadA/gadagada/Daha
crawl	refga
creak	caramarA/caracarA/kadakadA
cream	milA/kuta/harA/dala
crease	gIFja
create	banA/raca
credit	mAnyawA
creep	refga/saraka/Kisaka/jA/Gusa/baDa
criminate	PazsA
crimp	sameta/sikoda/ENTa/moda
cringe	xubaka/sikuda
crinkle	gIFja
crisp	bata
croak	tarrA/BarrA
crook	moda/muda[modanA]
croon	gunagunA
crop	ropa/lagA/kawara/kAta/CAzta/cara/CANta/bo/woda/xe
cross	moda/KiFca/jA/Beja/roka
cross-fertilize	para-niRecana
crouch	xubaka
crow	kilakAra
crowd	TUzsa/Guseda/GusA/Gera/Bara/TUMsa
cruise	cala
crumple	sikoda/gIFja
crunch	caramarA/kucala
crush	kucala/xabA/pera
crust	DAka/Daka
cry	ro/nikAla/mAzga/kaha/cillA/BUzka/bawA/bahA
cry_verbal	BUzka
cuddle	cipata[cipatAnA]
cull	cuna
cultivate	ugA/suXAra/pAla/kara/baDA
cup	pakada
cure	suXAra/milA
curl	sikoda/muda/moda/lapeta/jA
curl_verbal	sikuda
curse	kosa
curve	muda/JukA/GumA
cushion	bacA
cut	kAta/woda/warASa/sulaJA/SilA/roka/PUta/nikAla/moda/mAra/kata/kara/hatA/CAzta/bAzta/baxala/A/cIra
dab	WapaWapA/powa/lagA/cupada
dabble	dubo/Bigo/sAna
damage	bigAda
damn	XikkAra/kosa
dance	nAca/Xadaka/uCala/nacA/laharA/kUxa
dangle	JUla/JulA/lataka
dare	lalakAra
darken	gaharA
dart	Japata/Pefka
dash	ud/takar/pataka
date	ho
daub	powa
daunt	dara[darAnA]
dawn	nikala/ho
deal	xe/mAra/calA/bAzta/bANta
debase	GatA
debate	soca/bahasa
decay	sadA/sada/bigada/Gata/muraJA
decide	sulaJA/niScaya/nipatA
decimalize	desImalAija
deck	sajA
declare	kaha/bawA
decline	Gata/Dala
decode	kUtAnuvAxa
decompose	sada
decorate	sajA
decoy	PazsA
decrease	GatA/Gata
decry	ninxA
deduct	kAta/GatA
deem	samaJa/mAna
deep-freeze	himIkaraNa
deepen	gaharA
defame	mAnahAnia
default	cUka
defeat	harA/roka/hArA
defend	calA/bacA
defer	tAla
define	bawA
deflect	hatA/muda
defraud	Taga
degenerate	bigada
degrade	apakRINana
delay	roka
delegate	sOp/sOmpa
deliver	pahuzcA/x/xe/sunA/sOmpa/Pefka/kara/bAzta/bawA/mAra/bacA
delve	Koja
demand	mAzga/mAfga
demolish	girA/DahA/DA
demonstrate	praxarSiwa/xiKA/xarSA/jawA
denote	xarSA/bawalA
denude	uGAda
deny	nakAra/ma
depart	ravA/CUta
depend	nirBara
depict	xarSA
deploy	PElA
deposit	raKa
depress	xabA/GatA
descend	uwara/uwAra/Dala
describe	KIFca/bawA/bulA
desert	wyAga/deserte/Coda
designate	xiKA
desire	cAha
desolate	ujAda
destroy	harA/girA
detach	kAta
detain	roka
detect	pakada
deter	roka
deteriorate	bigada
dethaw	piGala/pigalA
detonate	ho
devastate	ujAda
develop	Xo/xiKalA/vikasiwa/PElA/Koxa/ho/banA/baDA/baDa
devote	vaPAxAra
dictate	liKavA
diddle	Taga
die	mara/muraJA/ho
differentiable	avakalanIya
diffuse	PElA/CiwarA
dig	samaJa/Koxa/Koja/kara/guxaguxAnA/guxaguxA/Dakela/banA
digest	saha/pacA
dike	KAI
dilate	PElA
dilly-dally	hicakicA
dillydally	hicakicA
dim	XImA/kara
diminish	GatA
dip	dubA/nikAla/nahA/nahalA/JukA/gira/duba/DAlU
direct	xilA/pratyakRa/Beja
disappoint	ho
disassemble	Kola
disburse	cukA
discern	xeKa/jAna
discharge	gira
disclose	Kola/xiKA/bawA
disconnect	kAta
discontinue	CudA
discourage	roka
discover	Koja/samaJa
disembark	uwara
disentangle	sulaJA/CudA
disfigure	bigAd
disguise	CipA
dish	parosa
dislodge	hatA
dismiss	BUl
dismount	uwara
dispatch	Beja/harA
dispense	bAzta/xe
disperse	CiwarA
dispirit	hawowsAhiwa
displace	hatA
display	xiKA/lagA/bawA
dispose	sajA
dispose-of	nipatA
dispute	Jagada
disseminate	PElA
dissolve	galA/Gula/Gola
dissuade	roka
distance	alaga
distend	PUla
distinguish	pahacAn/pahacAna
distort	ENTa/sikoda
distribute	bAzta/PEla
distrust	SafkA
disturb	GabadA/Ceda/sawA
ditch	uwAra
ditto	xoharA
divert	Pera
divest	uwAra/Coda/uGAda/CIna
divide	bAzta/bAMta/Pata
do	kara/Xo/xe/sulaJA/sIKa/sazvAra/sajA/pUrA/pakA/pahuzcA/liKa/le/karanA/ho/camakA/calanA/calA/BUgawa/Bugawa/baxala/banA/A
dock	kAta
document	liKa
dodge	kawarA
dole	bAzta
domesticate	pAla
don	pahana
dot	banA
double	xoharA/A
double-park	kara
douse	Bigo/DAla/buJA
down	hAra/girA/Coda/bigAda
doze	UzGa
draft	liKa
drag	GasIta/le/KIFca/dAla
drain	suKA/baha
drape	sajA/oDa/latakA/Daka
draw	nikAla/nikala/mila/liKa/le/KulavA/KIFca/kAta/kara/cAha/bawA/Bara/banA/bahA/A/AkarRaNa
dread	dara
dredge	Cidaka/CidakAnA-PElA
drench	Bigo/BigA
dress	sazvAra/sajA/CAzta/banA
dribble	tapakA/tapaka
drift	guFja/baha/GUmanA-Pira
drink	saha/pI/pII/nigala/le/KA
drip	tapakA/tapaka/cU
drive	hAzka/Toka/sazBAla/mAra/Kaxeda/kara/hazka/GUmA/calA/banA/BagA/Tofka
drizzle	Cidaka
drone	BinaBinA
droop	kumhalA/Juka
drop	gira/xe/uwAra/liKa/Ko/kaha/JukA/girA/gazvA/GatA/dAla/Beja/bawA/Coda
drown	dUbA/dUba[dubAnA]
drub	Toka/pIta
drug	pilAnA
drum	WapaWapA/pIta/bajA
dry	sUKA/sUKa/poFCa/suKA
duck	tAla/JukA/BUla/Juka
dull	nikAla
dump	Pefka/dAla/pataka
dunk	dubA
dupe	Taga
duplicate	xoharA
dust	poFCa/JAda/Cidaka
dye	rafga
dynamite	ud
ear	suna
earn	kamA/pA
earth	Daka
eat	KA/pI/cabA
ebb	uwara
echo	xoharA/guzja
edge	ukasA
educate	siKA/siKa/paDAnA-liKA/paDA
efface	mitA
egg	ukasA/uBAda
eke	calA/baDA
elapse	bIwa
elbow	gusA
elect	varaNa/cuna
elevate	uTA/baDA
elicit	nikAla
eliminate	nikAla/hatA
elongate	wAna/badA
emanate	nikala
embark	caDa[caDAnA]
embellish	sazvAra/sajA
embezzle	gabana
embroil	ulaJA/ulaJa[ulaJAnA]
emerge	nikala/uBara
emit	nikAla/Coda
empale	bInXa
empty	nikAla/Coda
encase	DAzka
encash	BunA
encircle	Gera
enclose	Gera
encompass	Gera
encourage	ukasA
end	nipatA
endure	saha
engage	bAzXa
engineer	iFjIniyara
engrave	Koxa
engulf	parigrahaNa
enhance	baDA
enjoy	sarAha/caKA
enlarge	baDA
enmesh	PazsA
enquire	pUCa
enrich	XanI
enshroud	Daka
ensnare	PazsA
entangle	ulaJA/PazsA
enter	jA/Guseda/GusA/Gusa/dAla/A
entertain	tikA/suna/mAna/basA
entice	PusalA/luBA
entomb	gAda
entrance	jA
entrap	PaMsA
entrust	sOmpa
entwine	gUzWa
enumerate	gina
envelop	lapeta
episode	GatanAa
equate	joda
eradicate	unmUlana
erase	mitA
erect	banA
erupt	PUta
escalate	bDA/baDa
escape	BAga
eschew	Coda/wyAga
espy	wAka/xeKa/wAda
essay	jAzca
establish	banA
esteem	mAna
estimate	Azka
etch	ukera
evade	tAla
exact	le
examine	samaJa/pUCa/paraKa
exasperate	KijA/BadakA
excavate	Koxa
excel	SreRTawara
except	Coda
exchange	kara/dAla
excite	ukasA
exclaim	cillA
exclude	nikAla/Coda
exercise	barawa
exhibit	xiKA
exhilarate	ho
exibit	xiKA
exist	raha/ho
exorcise	nikAla/BagA
exorcize	nikAla/BagA
expand	PEla/Kula/baDa/PElA
expel	nikAla
experience	Boga
explain	samaJA/bawA/bawalA
explode	PUta/bawA/badA/bada
explore	Koja
expose	Kola/xiKA/dAla/vivaraNa
expound	samaJA
express	nicoda/bawA
expunge	mitA
extend	PElA/xe/PEla/baDA
extenuate	GatA
extinguish	buJA
extol	sarAha
extort	ugAha/ENTa
extract	KIFca/nikAla
extricate	CudA/nikAla
exude	pasIja/tapaka/baha
eye	xeKa
fabricate	banA/gaDa
face	muDa/GumA/Guma/sAmanA-ho/kara
fade	muraJA/nisweja
fail	cUka/asaPala/unuwwIrNa/gIra
failure_verbal	gira
fall	uwara/pahuzca/pahuMca/padanAa/pada/nikala/mAna/laga/Juka/Jada/ho/girA/gira/Gata/Daha/CA/bigada/barasa/A
fall-apart	tUta
fallow	jowa
falter	hicakicA/ladaKadA/dagamagA
fan	Pataka/BadakA
fancy	soca/cAha
fasten	jakada/Wopa/kasa/gadA/cipakA/bAnXa/atakA
fatigue	WakA
fear	hicakanAa/dara
feature	xiKA
federate	safGabaxXa
feed	KilA/dAla/carA/cara/calA/Bara/BadakA
feel	tatola/samaJa/laga/jAzca/CU
fence	tAla/Gera
fend	roka
ferret	Koja
fester	sada{GAva}
fiddle	Kela
fidget	culabulA
field	pakada
fight	lada
file	Gisa
fill	Bara/KilA/KA/dAla/bawA
film	PilmA
filter	CAna
find	pA/mila/Koja/DUzDa
finger	CU/bajA
fire	xAga/pakA/calA
fish	pakada
fit	joda/samA
fix	joda/xeKa/pakA/niSciwa/lagA/GUra/gadA/baDA
fizz	sanasanA
fizzle	sanasanA
flag	murJA
flame	xahaka/camaka
flap	PadaPadA/laharA/hila[hilAnA]
flare	camaka[camakAnA]/XaXaka/Badaka
flash	camaka/xamakA/timatimA/suJa/muskA/camakA/xiKA
flash_verbal	camakA
flaunt	xiKAvA
fleece	lUta
flex	moda/JukA
flick	Jataka/JAda/hilA
flicker	camaka/timatimA/PadaPadA/Jalaka
flight	uda
flinch	karAha/hicaka
fling	Pefka/pataka/dAla/hilA
flip	uCAla/palata
flirt	Kela
flit	mazdarA
float	baha/wEra/udA/soca/PElA/mazdarA/calA/bahA
float-about	PElA
float-around	PElA
flog	beca
flood	Bara
flop	PadaPadA
flop-back	gira
flounder	ataka/latapatA/ladaKadA
flour	pIsa/pisa/Cidaka
flourish	panapa/hilA
flout	avahela
flow	baha/laharA/Dala/cala/saraka
flower	Kila/baDa
fluctuate	GatanA-baDa
fluff	PulA
fluff-out	PulA
fluff-up	PulA
flummox	GabarA
flump	pataka
fluster	GabadA
flutter	PadaPadA/Xadaka/uda/PadakAa/laharA/hilA
fly	uda/udA/uCAla/PadaPadA/pada/laharA/lahara/hadabadA/calA/bIwa/PaharA/BAga
foal	biyA
fold	moda/milA/lapeta/Daka/cipatA/BAFJa
fold-in	PeNta
fold-into	PeNta
follow	samaJa
foment	ukasA
fondle	pucakAra/xulAra
foot	cukA
forage	DUzDa
forbid	roka
force	Xakela/nikala
forecast	bawA
foreclose	roka{qNa}
forego	wyAgae
forge	gaDa/DAla/banA
forget	BUla
forgo	wyAgae
form	soca/sIKa/gaDanAa/gaDa/banA
formalize	niSciwawA
fortify	majabUwa
forward	Beja/baDA
foster	pAla
foul	ulaJA
fragment	woda
frame	PaMsA
fray	uXada/ciDa/Waka
free	nikAla
freeze	jama
freight	Bara
frighten	darA/BayaBIwa
fritter	gazvA
fruit	Pala
fry	wala
fuel	dAla/BadakA
fulfil	niBA
full	Xo
fulminate	Barwsa
fumble	tatola/gadabadA
funnel	dAla
furl	lapeta
furnish	sajA
fuse	piGalanAa/juda/milA/gala
gab	badabadA
gag	ubaka
gain	suXAra/pA/mila/kamA/jIwa/baD/baDA/baDa/pahuFca
garnish	sajA
gasp	hAzPa/hAmPa/cihA/cAha
gather	samaJa/le/kAta/cuna/batora/baDA/baDa
gauge	nApa/BAzpa/Azka
gawk	GUra
gaze	GUra
gel	jama
generate	kamA/jana
germinate	uga
get	pA/xe/uwara/ukasA/suna/suJa/samaJa/raK/raha/PAzsa/PasA/pakA/pakada/pahuzca/pahuMcA/nikala/mila/mAra/le/lA/la/lagA/laga/Karixa/karavA/karA/kara/kamA/jIwa/jAna/jA/ho/dAla/Coda/ciDA/Beja/batora/banA/BadakA
get-back	lOta
get-behind	piCada
get-down	uwara
get-in	Gusa/pahuzca
get-off	Coda/baca
get-out	nikala
get-over	uBara
get-through	pahuzca
get-together	mila
get-up	uTa
gird	bAzXa
girdle	Gera
give	xe/xilA/xiKA/ucakA/sunA/sOmpa/piGala/parosa/pahuzcA/nikAl/nikAle/nikAla/mAra/le/lagA/kula/Kola/kara/hAra/caDA
give-away	xe/bAzta
give-on	pahuzcA
glance	camaka
glare	camaka/warera
glaze	camakA
gleam	camaka/camacamA
glean	batora/bIna
glide	uwara/uda/Pisala
glimmer	timatimA/Jalaka
glint	camaka/Jalaka
glisten	camaka
glitter	camaka/jagamagA
glow	camaka/rafga
glue	lagA
gnaw	kuwara
go	jA/PEla/Pata/pahuzca/laga/kara/honA/ho/goa/calA/cala/bIwa/bika/baja/baDa
go-down	dUba
go-through	punaHjA/saha
go-up	baDa/caDa
goad	ukasA
gobble	GuraGurA/Bakosa
going_verbal	jA
gorge	Bakosa
gouge	ugAha/Koxa/ENTa
grab	Japata/pakada
grade	banA
graft	joda
grant	xe/mAna
grapple	pakada
grasp	pakada/samaJa
grass	carA
grate	caracarA/aKara/ragada
gravitate	KiFca
graze	carA/cara
greet	mila
grieve	xuHKae
grill	Buna/BUna
grin	haMsa
grind	pIsa/ragada
grip	pakada
grizzle	pinapinA
groan	karAha
grope	tatola
grouch	KIja
ground	uwAra
grow	baDa/upajA/ugA/PEla/pAla/jA/baDA/A
growl	gurrA/BunaBunA/badabadEYA
grub	Koja
grumble	garaja/gadagadA/BunaBunA
grunt	GuraGurA/BunaBunAnA/BunaBunA
guard	CupA
gulp	hAzPa/gataka
gurgle	gadagadA
gutter	WaraWArA
guzzle	gataka
gyrate	GUma/GumA
habit	Axawa
habituate	sAXa
hack	TaTaka/mAra
hail	bulA/pukAra
halt	rUka
hammer	Tofka/gad
hand	sOmpa/xe
handle	sazBAla/CU/cal
hang	tAfga/tAmga/saJ/latak/lataka/lag/JUla/Juk/C/CA
hang-up	tAzga
hanker	warasa
happen	ho
hark	suna
harness	jowa
hatch	banA
haul	Do/Xakela
have	mila/xil/raKa/pI/KA/karav/jAna/ho/hE/dAla
head	praWama
heal	Bara
hear	suna
heat	ukas
heave	uTA/laharA
hector	darAnA-XamakA/XamakA
hedge	hicakicA
heel	kucala
heist	curA
help	bac
hesitate	hicakicA
hew	cIra
hide	CipA/Daka
hinder	roka
hiss	PuPakAra/sisakAra
hit	takr/takarA/p/pA/pahuzca/mAra
hitch	bAzXa
hobble	CAzxa/atakA
hoist	uTA/PaharA
hold	pakada/tika/Tahara/ruka/raKa/rac/man/mAna/ho/diK
holler	cillA
hollo	cillA
honour	mAna
hook	tAzga/tAmEYga/Pazs/PazsA/moda/mara
hoot	GuGuA
hop	Puxaka
horse	Do
house	raKa
hover	mazdarA/hicakicA
howl	cillA
huff	JuzJalA
hull	CIla
hum	gunagunA
humble	nIcAxiKA
hump	lAxa
hunch	JukA
hybridise	safkariwa
hybridize	safkariwa
ice	mAra/jam
identify	samaJa/pahacAna
ignite	sulaga/jalA/jala
ignore	anaxeKA
imagine	soca/mAna
imbibe	soKa/pI
immerse	dubA
impact	praBAva/takkara
impair	bigAd
impale	Cexa/PazsA/bInXa
impart	bawA
impede	roka/atakA
impel	Xakela/Tela
impinge	takarA
implant	bETA/bETa
implantation	lagA
implicate	PazsA
imply	samaJa
impose	lagA
improve	suXara/suXAra/baDA/saMSoXana
inadvertence	BUla
inch	sarakA/saraka
incite	BadakA
incline	Juka/JukA
inclose	Gera
include	milA
incorporate	sammiliwa
increase	baDA/baDa
incriminate	PazsA
incubate	se
indicate	xiKA
indite	liKa
induce	lA
infest	sawA
inflame	bigada/BadakA
inflate	PulA/baDA
inflict	pahuzcA
inform	bawA
infuse	udela
ingeminate	xoharA
ingest	KilA
inhabit	basa
inherit	pA
inhibit	roka
initialise	ParmEta
initialize	ParmEta
inject	lagA
injure	GAyala/Ahawa
input	dAla
inquire	pUCa-wACa/pUCa
inscribe	CApa
insert	joda
inset	jada
insist	mAzga
inspect	jAzca
install	bETA/lagA[yanwra]
instigate	BadakA
instil	siKA
institute	lagA
instruct	siKA/samaJA/kaha/bawA
insulate	bacA
insure	xilA
integrate	joda
intend	raKa/cAha
inter	gAda{lASa}
interconnect	joda
interject	toka
interlace	gUzWa
interlink	joda/milA
intermingle	mila/milA
interpenetrate	PElA
interpose	GusA
interrupt	toka/roka/kAta
intertwine	bata/lapeta
interweave	gUzWa
intimate	bawA/bawalA
intimidate	XamakA
introduce	lagA
intrude	Gusa
inveigle	manA
invent	gaDa/banA
invest	xe/sajA/lagA
investigate	jAFca/jAzca
invite	ukasA/mAfga/luBA/bulA
invoke	bulA
irradiate	jagamagA/camakA
irrigate	sIzca
issue	xe
iterate	xoharA
jab	koFca
jabber	badabadA
jade	WakA
jam	xabA
jangle	JanaJanA
jar	Kataka
jaw	daNta/CIdaka
jeer	ciDA
jerk	uKAda/Jataka
jig	uCAla/uCala/nAca
jiggle	hilA
jingle	KanakA/JanaJanA/KanaKanA
jockey	Taga
joggle	hilA
join	milA/mila/laga/joda
joint	milA/joda
jolt	hilA
josh	ciDA
jostle	Xakela
judge	wOla/Azka
jumble	milA
jump	kUxa/uCala/pakada/lAnXa/darA/dANta/cOfkA/baxala/baDA/baDa
jump-on	toka
keel	ulata/gira
keep	raKa/raha/roka/pAla/liKa/calA/cala/niBA/wabiyawa
keep-oneself-in	lagAwAra
ken	jAna
key	manA
kick	TukarA/nikAla/mAra/lawiyA/Guma/Coda/calA/XikkAra
kick-up	upaxrava
kill	mAra/kAta/hatAa/gazvA
kindle	jalA/sulagA
kink	dAla
kip	so
kiss	cUma/CUU/sahalA
knacker	Waka{inf.}
knead	gUzxa/sAna
knife	Gompa
knit	sikoda/juda/buna
knock	Tofka/takarA/KataKatA/kAmpa/KadaKara/GaraGarA
knot	bAzXa/ulaJA
know	jAna/samaJa/pahacAna
knuckle	TunakA
knuckle-down	Juka
knuckle-under	Juka
lace	PazsA/milA
ladder	cad
ladle	parasa
lag	piCada
lance	cIra
land	xe/uwAr/uwAra/uwara/p/pahzuca/mila/l/jam
languish	gira
lap	takarA
lash	takarA/PatakAra/GUma/bAzXa
last	tika/Tahara/cala
latch-on	samaJa
laugh	hazsa/muskur/hzsa/hzas/hzasa
laughter	muskur
launch	jalAvawaraNa/Coda
lave	ulIca
lay	raKa/xe/mAra/leta/kara/jam/Jada/gir/dAla/ban/biCA
leach	niWAra
lead	jA/biwA
leak	cU/risa
lean	Juka/Juk
leap	uCala/kUxa
learn	sIKa/siKa/rata/paDa/jAna
leave	xe/pahzuc/Coda/tAla
lecture	PatakAra
left	Coda
leg	cala/BAga
lend	xe
length	baD
lessen	Gata
let	xe/nikala/bah/xo{Ane/jAne
levy	ugAha
lick	cAta
lid	roka
lie	Tik/lYeta/leta
lift	uTA/uT/Koxa/curA
ligate	bAnXa
light	jalA/camaka
like	cAha
limp	lazgadA/lafgadA
line	mAra/Daka/Bara/ban
link	joda
liquidate	xabA
lisp	wuwalA
list	Juka
listen	suna
litter	biKera
live	raha/jI/biw
load	lAxa/dAla/Bara
lob	uCAla
lock	ulaJa/moda
lodge	Tahara/raKa/TaharA
loft	uCAla
log	kAta
loll	bETe/lataka
long	warasa/lalaka
look	xeKa/xiKa/bul/walASa
loop	muda
loose	Kola/Coda
loot	lUta
lop	kAta/CAzta
lose	hAra/gazv/Ko
lounge	suswA
love	cAha
lower	uwAra/kama/juk/Juka/gir/gira/Gat/GatA
loyal	xeSaBakwa
lug	KIFca/GasIta
lump	mil
lunge	Japata
lure	luBA
mail	Beja
make	banA/xe/uTa/socanA/samaJa/pakada/pahuFca/liKa/laga/kara/kam/gira/DAla/ban/bana/bana[banAnA]
manage	samBAla/raKa/le/cal
mandate	sOmpa
mangle	kRawa-vikRawa/bigAda
manhandle	pIta
manipulate	calA
manufacture	gaDa/banA
march	jUta/cala
mark	liKa/darSA
market	beca
mash	kucala
mask	CipA
massage	mala
masticate	cabA
match	mil/mila
mate	milA
may	samBavawaH/saka/le
mean	raKa/ho/cAha
meander	GUma
measure	nApa/wOla/mApa/Afka
mechanise	maSInIkaraNa
meet	mila/joda/ho
melt	piGalA/piGala/gala
mend	suXAra/sI/mitA/banA
mention	kaha
merge	milA/mila
merit	sarAha
mesh	Pazsa
mete	Boga
mete-out	xe/BugawavA
might	sakeg/hogA{SAyaxa}/saka
milk	xuha/Taga
mill	pIsa
mime	mUkABinaya
mind	xeKa
mingle	milanA-jula
mire	PazsA/ataka/atakA
mislead	bahakA
miss	cUka/Coda
misspend	gazvA
mix	mil/milanA-jula/mila/milA/Gula
moan	karAha
mock	ciDA
model	gaDa
modify	saMSoXana/suXAra
mold	gaDla
molder	sada
mollify	manA
monitor	xiKA/xarSA
moo	razBA
moor	bAzXa
mop	poCa
mould	gaDa
mount	cipakA/caDa/baDa
mouse	Koja
move	cala/nikAla/JakaJora/hila/hata/calA/baxala/baDa
move-about	cala/tahala
muddle	gadabadA
muffle	lapeta
mug	lUta
multiply	baD
mumble	buxabuxA/guNaguNA
munch	cabA
murmur	sarasarA/badabadA
muss	ulaJA
must	pada/cAhiye
mutate	parivarwiwa
mutilate	kAta
mutter	badabadA
nag	sawA
nail	pakada/mAra/lagA/jamA/jakada
name	pahacAna
narrate	sunA
needle	sI/piro/ciDA/BadakA
negate	nakAra
neigh	hinahinA
nest	jamA
net	PazsA/pA/pakada/kamA/dAla/DAka/bAzXa
nettle	ciDA
neuter	be-asara
neutralise	be-asara
neutralize	be-asara
nibble	kuwara/tUfganA
nicker	hinahinA
nip	kAta/cuBa
nod	UzGa/JUma
noise	PElA
nose	sUfGa/Koja/DUzDa
notice	xeKa/vicAra
number	gina
numerate	gina
nurse	xe/samBAla/pI/pilA/parosa
nurture	pAla
nut	Koja
obliterate	mitA
observe	xeKa/kaha/niraKa
obstruct	roka
obstrude	Wopa
obtain	pA/le/haWiyA
obtrude	Wopa
occupy	raha/samBAla
occur	ho/A/Gata/sUJa
occurence	Gata
offer	xe
omit	hatA
ooze	tapakA/baha/cU
open	Kola/Kula/Kila/banA/baka/baDa
operate	calA/cala
oppose	viroXI/roka
opt	cuna
oscillate	dola/hicakicA/GatanA-baDa
ought	cAhie
out	nikala/gira-jA
outface	GUra
outline	xarSA
outmanoeuvre	harA
outstare	GUra
overcome	harA
overhang	lataka
overpass	BUla
oversight	BUla
owe	cAha
own	apanA
pack	cuna/Bara
package	baXa/Bara
paddle	hilAnA-dulA
page	pejara
paid	xe/cukA
pain	sawA
paint	sajA/razga/rafga/liKa/banA
pair	milA
palaver	manA
pale	Gera
palpitate	Xadaka/Padaka
pan	GumA
panic	GabadA
pant	hAzPa/hAmPa
paraboil	ubAla
parade	xiKA/ikaTTA
parallel	mila
parch	Buna
pare	kAta/GatA/CIla/CAzta
park	Coda/coda/bETa
parrot	rata
part	Cazta/Cazt/buCuda/biCuda/alagaho
pass	gujara/xe/ruka/Pera/PElA/nikala/jA/GumA/gujAra/dAla/calA/cala/biwA/bahA/baha
passing_verbal	biwa
paste	satA/cipakA
pasture	carA/cara
pat	WapaWapA/poFCa
patch	Daka/joda
patter	patapatA/badabadA
pattern	sajA/banA
pause	ruka/Tahara/rUka/ataka
pay	xe/kara/jA/ho/cukA/cukA{pEsA}
peak	pahuzca
peal	GanaGanA/gadagadA
peck	cuga
pedal	calA
peddle	PElA
peek	JAzka
peel	Cila/gira/CIla
peep	JAzka
peer	xeKa/wAka
peeve	ciDA
peg	xarSA
pelt	Pefka
pen	raca/liKa/Gera
pencil	banA
penetrate	Gusa/samaJa/Bexa
people	raKa/basA/basa/Bara
pepper	dAla/Cidaka/barasa
perambulate	tahala/GUma
perceive	xeKa/samaJa
perch	bETa
perforate	Cexa
perform	#kara/xiKA/xeKa/samBAla/nibAha/Kela/gA/bajA
perish	mara
perpetrate	kara
persecute	sawA
persist	adajA
persuade	manA/samaJA
pester	sawA
pet	xulAra
petrify	paWarA
phrase	kaha
pick	woda/ukasA/le/kurexa/Kuraca/Koxa/KIFca/KarIxa/KA/hatA/GusA/dAla/curA/cuna/cuga/CAzta/banA/bajA/BadakA
pick-up	uTA
piece	lagA/joda/bETA
pierce	Bexa/cuBA
pig	KA/byA
pigment	rafga
pilfer	curA
pillage	lUta
pillow	raKa
pilot	calA
pin	joda/Cexa/bAzXa
pinch	kAta/curA/cAzpa
ping	GaraGarA/BanaBanA/sanasanA
pinion	jakada/bAzXa
pink	sajA/GaraGarA
pipe	sajA/kUkA/gA/cillA/cahacahA/bola/bajA/cahaka
piss	mUwa
pitch	Pefka/gira/dUba/bETA/lagA/dUbanA-uwarA
placate	manA
place	raKa/xe/lagA/kara/pahacAna
plane	udA
plank	pataka
plant	ropa/PElA/lagA/kara/jamA/gAda/Coda/CipA/bo/basA
plaster	cipakA
play	Kela/xiKA/tumaka/PEla/Peka/niB/niBA/macala/lag/Kil/kara/cal/cala/baj/bajA/baja/axA
play-up	sawA
play-with	soca
please	cAha
pledge	prawijFA
plonk	pataka
plough	jowa
pluck	woda/noca/KIFca/bacA/oca
plug	mAra/Bara
plumb	samaJa
plump	PulA
plunder	lUta
plunge	PazsA/kUxa/Guseda
plunge_verbal	dUba
plunk	pataka
ply	AnA-jA
poach	anaXikAra
pocket	haWiyA/hadapa
point	xiKA/xarS/wAna/uT
poise	ruka
poison	bigAda
poke	Dakela/nikAla/nikala/koFca/JAzka/banA/cuBo
polarize	XruvIkaraNa
pole	Tela/cal/calA
polish	camakA/camak
poll	mila
pollard	CAzta
ponder	soca
pop	wadaka
populate	basa/basA
portray	xarSA
posit	mAna
position	jam
possess	raKa
post	dAla/cipakA/Beja
postulate	mAna
pot	raKa/Bexa/pilA
pounce	Japata
pound	XakaXakA/Tumaka/pIta/mukiA/Guna/mAra/Xadaka
pour	baha/xe/udela/nikAla/labalabA/DarakA/barasA/bahA
powder	pIsa
powderise	pIsa
powderize	pIsa
praise	praSaMsA/swuwi
prank	sazvara
pre-empt	roka
pre-record	xiKA/liKa
preclude	roka
preen	bananA-Tana/savAzra
prejudge	pUrvanirNaya
preordain	pUrva-nirXAraNa
preparation	banA
prepare	pakA/banA
present	xe/sUJA/sAXa/raKa/A/xe{upahAra}/xiKA
preserve	bacA
press	xabA/Wopa/nicoda/baj/Gera-le
pressurise	xAbAnukUla
prettify	sazvAra
pretty	sajA
prevent	roka/bacA
prick	kosa/cuBA/cuBa/Cexa
prickle	gada/cuBa/Cexa/cuBA
pride	iwarA
print	lagA/CApa/CapA
proceed	cala
process	DAla
procrastinate	vilamba/tAla
procure	jutA
prod	cuBA/koFca/kIFca
produce	jana/banAa
proffer	xe
profile	CApa
progress	cala/baDa/agrasara
prohibit	roka
project	Pefka/dAla
promenade	tahala
prompt	ukasA/jawA
pronounce	sunA/paDa
proof	paraKA
prop	tikA
propagate	PElA/ugA/PEla
propel	Xakela/ukasA/Tela/Pefka
prospect	Koja
prostrate	girAxe
protect	bacA
protectionism	saMrakRaNavAxa
prove	PUla/paraKa/jAzca
provide	xe/kara/kaha/jutA
provoke	ciDa/Ceda
prune	CAzta/CaztAIa/kAtanA-CAzta
pry	woda
publish	liKa
pucker	sikoda
puff	udA/hAmPa
pull	KIFca/TaharA/roka/pI/PAda/noca/nikAla/le/KIzca/Ke/kara/JatakAra/EzTa/uKAda
pull-in	kamA
pull-into	pahuzca/ruka
pull-off	ruka
pull-out	hata/hatA
pull-up	ruka
pull_verbal	Ke
pull{sth}-over	ruka
pulsate	Xadaka/Padaka
pulverise	pIsa
pulverize	pIsa
pummel	WukiyA
pump	uTA/ulIca/Bara
punch	xAla/xabA/Cexa
purchase	KarIxa
purl	kalakalA
purloin	curA
purr	GuraGurA
purse	sikoda
pursue	baDA
push	Xakela/ukasA/Tela/calA/baDA
put	raKa/mAra/liKa/lagA/dAla/Azka/Pefka
putrefy	sada/sadA
putt	mAra
putter	patapatA
quaff	gataka
quake	kAmpa/hila/kAzpa
qualify	suXAra
quaver	kAzpa
quell	xabA/SAnwa
quench	buJA
query	pUCa
quest	walASa/ro
question	pUCa
quieten	SAnwa
quirk	moda
quiver	kAzpa
race	BAga
rack	ugAha/JakaJora/ENTa/ho
radiate	PUta/nikala/camaka/biKera
radio	Beja
rage	JuFJalA
rain	umada/gira/barasa
raise	vasUla/uwwejiwa/uTA/ukasA/uBAda/nikAla/macA/KIzca/kiyA/kara/kaha/gaDa/dAla/BadakA/baDA/badA
rake	PirA/DUzDa/batora
rally	samBala
ram	TUsa/kasa/BidanAra/TUzsa
ramble	GUma
ramp	uCala
rankle	paka
ransack	lUta
ransom	CudA
rant	garaj
rap	TakaTakA/KatakatA
rape	lUta
rasp	ragada
rate	samaJa/mAna/gina/dAzta
rattle	KadaKadA/KanaKanA/KadaKaA
ravage	ujAda
rave	garaj
ravel	sulaJA
raven	SikAra/lUta/Bakosa
re-echo	gUzja
reach	pahuzca/PElA/PEla/pA/pahzucanAI/pahzucA/pahzuca/pahuzc/pahMuca/baDa/pahuzcA
read	paDa/wAda/wADa/samaJa/bUJa/bAzca/bawA/xeKa/xiKA
realize	samaJa
reap	kAta
reapply	punarAvexana
rear	pAla/uTA
reave	lUta
rebuff	roka
rebuke	PatakAra
recapture	pakada
recede	Gata
receive	pA/mila/le
recite	sunA
reckon	mAna/samaJa/gina
reclaim	suXAra
recline	Juka
recognise	pahacAna/mAna
recognize	pahacAna/mAna/jAna
recoil	TiTaka
reconcile	milA/manavA
record	tIpa
recount	sunAa
rectify	suXAra
redeem	cukA/BajA
redouble	baDA/xoharA
redress	suXAra
reduce	GatA/sikoda/jIwa/Gat/Gata
reel	ladaKadA/cakarA/GUma
refer	Beja/sOmpa
refine	suXAra
reflect	xarSA
reform	suXAra
refract	moda
refrain	Ada
regard	mAna/xeKa/soca/samaJa/GUra
register	bawA
regret	paCawA
rehearse	xuharA/xoharA
reinforce	baDA
reinvent	peSa
reiterate	xoharA
reject	Pezka
relate	bawA
relay	pahuzcA
release	nikAla/nikala/Kola/Coda/bawA/vimocana/wyAga
relieve	uTA/Coda
relinquish	wyAga
remain	Tahara/raha
remark	kara/kaha
remedy	suXAra
remind	ciwA/cewA
remit	sOmpa/GatA/Beja
remonstrate	dAzta
remove	nikAla/hatA/CudA
rend	Pata/PAda/cIra/cira/CIna/cillA
render	xe
renew	xoharA/baxala
renounce	Coda/Ko
renovate	navIkaraNa
repair	suXAra/jA/banA
repay	cukA/lOtA
repeat	xoharA/tunatunA
repel	hatA/xUra/roka
repent	paCawA
replace	baxala/hatA
replicate	xoharA
report	bawA/liKa
repose	leta
represent	xarSA/raKa/jEsAI
repress	xabA/kucala
reprimand	PatakAra/Jidaka
reprobate	XikkAra
reproduce	xiKa
reprove	PatakAra/dAzta
repudiate	nakAra
request	mAzga
require	mAzga/cAha
rerun	xoharA
rescue	CudA/bacA
reshuffle	PeNta
reside	raha/ho
resist	roka
resonate	gUzja
resound	gUzja
rest	tikA/tika/Tahara/suswA/resta/leta
restate	xoharA/bawA
restrain	roka
restrict	parimiwa
retain	roka
retch	ubaka
retouch	anuSoXana
retrace	xoharA
retreat	gira/BAga
retrieve	suXAra
return	lOta/xe/vApasa/lOtA
reveal	xiKA/bawA
reverberate	gUFja
reverse	ulata
review	paraKa
revile	XikkAra
revise	xuharA/xoharA/suXAra/baxala
revolve	GUma/GUMa/Guma
rewind	lapeta
rib	ciDA/joda
rid	Coda
ride	wEra/calA/caDa
right	suXAra
ring	nAWa/Gera/bajA/baja
rinse	KafgAla/Xo
rip	PAda/Pata
ripen	paka/pakA
ripple	laharA
rise	uTa/uga/PUla/nikala/caDa/baDa
riven	cIra
roam	GUmanA-Pira/GUma
roar	xahAda/garaja/cillA/GadaGadA
roast	suKA/sefka/pakA/BUna
rob	lUta/CIna
rock	JUlA/JulA/hilA/hila/dola
roll	luDaka/PirA/luDakA/lapeta/dagamagA/GUmA/GumA/bela
roof	CA
rook	Taga
room	raha
roost	bETa
root	kurexa/Koxa
rot	sadA/sada
rotate	GUma/GumA
rough	pIta
round	batora
rouse	jAga/uwwejiwa/uTA/jagA/BadakA/BadakAa
rout	Koxa
rove	GUma
row	rava/calA/Ke/Jagada
rub	mala/mitA/lipa/Gisa/ragada
ruck	raka/Sikana
rue	paCawA
ruffle	PeNta
ruin	bigAda
rumble	lada/gadagadA
rumple	sikoda/gIFja
run	xOda/xOdA/xodA/uTA/ujeda/risa/piGala/Pera/PElA/PEla/kOXa/jI/gala/dAla/DalakA/CApa/calA/cala/bIwa/Bara/baha
rupture	woda
rustle	sarasarA/curA
sabotage	bigAda
sack	lUta
safeguard	bacA
sag	Juka
sail	wEra/calA
sale	beca
sally	nikala
salt	lag
salvage	bacA
sample	caKa
sang	gAyA
sank	dUbA
satisfy	pasanxa
saunter	cahala
savage	kAta
save	roka/baca/bacA
saw	xeKA/calA
say	kaha/kah/bolanA/bola/bawA/bawal
scald	jalA/ubAla
scale-up	badA
scan	CanxabaxXa
scarch	Julasa
scare	dara/darA/dara[darAnA}
scarf	Bakosa
scatter	CiwarA
scene	Gata
scent	sUzGa/BAzpa
scheduled	parigaNiwa
school	siK/paD
scintillate	camaka
scoff	Bakosa
scold	dAzta/PatakAra
scoop	pA/banA
scorch	jala
score	KaroFca/banA
scorn	TukarA
scour	mAja/mAzja/Gisa
scout	Koja
scrabble	tatola/GasIta/KaroFca
scram	Xawa
scrape	CIla/Kuraca/Koxa/KaroFca/KadaKadA/Cila/ragada/Gisa
scratch	mitA/KujalA/Koxa/KIFca/KaroFca/Kuraca/GasIta
scrawl	GasIta
scream	cIKa/cillA
screech	cillA/cIKa
screen	bacA/CipA/jAzca
screw	moda/maroda/laga/kasa/GumA/guma
scribble	GasIta
scrunch	caramarA
scruple	JiJaKa
scrutinise	jAzca
scrutinize	jAzca
scud	uda/bhjA
scuff	ragada
sculpt	gaDa
scythe	kAta
seal	cipakA
sear	JulasA
search	tatola/Koja/Gusa/DUzDa
season	sUK/sIa
seat	bET/bETa/bETA
secrecy	Cip
secrete	CipA
section	kAta
seduce	bahakA/luBA
see	xeKa/xiK/xeka/samBAla/samaJa/mila
see-Saw	GatanA-baDa
see-saw	GatanA-baDa
see-through	samaJa
seed	CAzta/CaNta
seek	DUzDa/mAzga/DUNDa
seem	laga
seen	xeKA
seep	risa
seethe	ubala/KOla
seize	pakada/samaJa/p/Cina/bAzXa/CIna
select	cuna/CAzta
sell	beca/Wopa/lAxa/cala/bika
send	Beja/ukas/pahuzc/pahuzca/nikala/mAra/j/garja/Bej
send-out-{sth}	bAzta
send-sb-off	nikAla
separate	roka/PEl/nikAla/biKera/bAzta/baNta
serve	xe/parosa/kAma/PAzxa/lAzGa/bAha
set	uwAra/ug/mil/majabUwa/liKa/lAg/lag/laga/kasa/kara/jam/jada/Gata/dUba/Coda/biC/bET/beT/bet/bETa/bEta/baxala/ban/bETA
settle	xe/Tehara/Tahara/roka/raha/nibat/lag/jam/cuk/bETa/bas/basa[basAnA]/cukA
sever	kAta
sew	tAfka/sI/p
shackle	roka
shade	bac/Daka/gaharA
shake	hilA/milA/kAzpa/kAmpa/JakaJora/jagA/Jada/hila/GumA/dAla
shake-down	biCO
shape	gaDa/banA
share	bAzta/bawA
sharp	Taga
shatter	PAda
shave	mUda/muzda/CIla
shear	kAta
shed	uwAra/PElA/nikAla/JAda/GatA/bahA
sheet	kasa/bAnXa
shell	CIla
shelter	rok/Cipa/bacA
shield	bacA
shift	lagA/KisakA/dAla/dagamagA/baxala
shilly-shally	hicakicA
shillyshally	hicakicA
shimmer	timatimA/JilamilA/camaka
shimmy	laraja/kAzpa
shin	caDa
shine	camaka/xamaka/jagamagA/camak/camakA
ship	lAxa/caDa/Beja
shirk	tAla/BAga
shit	mala
shiver	kAzpa
shock	hila/cakiwa/cOfka
shoo	BagA
shoot	xe/xAga/uwAra/Pefka/PElA/nikAla/nikala/mAra/mara/le/lagA/Kela/girA/dAla/Dakela/COda/Coda/calA/bola/Beja/Bara/banA
shop	pakadA/pakada/KarIxanAa/KarIxa
shore	uTA
shot	xAga/mAra
shout	cillA/pukAr/cIKa/bulA
shove	Dakela/Xakela/dAla
show	xiKA/xikA/xarSA/samaJA/bawA/bawalA/A
shower	gira/barasA/barasa
shred	kawara
shriek	cIKa/cillA
shrink	sikuda/sikoda/Gata
shrivel	muraJA/kumhalA
shroud	Daka/CipA
shudder	kAzpa/hila
shuffle	ragada/hera-Pera/GasIta/PeNta
shun	baca
shut	atakA
shy	Pefka
sieve	CAna
sift	Cana/CAnabIna
sigh	sarasarA/warasa
sight	xeKa
sign	xe/sOmpa
simmer	ubAla/Kaxaka
sing	gA/sunA/sarasarA/sanasanA/gUzja/gunagunA/cahacahA/BanaBanA/bajA/baja
singe	Julasa/JulasA
single	cuna
sink	dUba/Xazsa/uwAra/uwara/soca/nikAla/Koxa/Juka/jA/ho/girA/gira/gazvA/Gata/dUbA/Dala/dAla/CipA/bETa
sit	bETa/xe/se/laga/bETA
sit-down	bETajA
site	banA
situate	raKa
size	sajA/lagA/CAzta
sizzle	kadakadA/surasurA/PanaPanA
skid	Pisala
skim	nikAla/CiCalA
skin	CIla/Cila
skip	CiCalA
skirt	Gera
skulk	Cipaka
sky	tAga/tAfga
slack	buJA
slacken	GatA
slake	buJA
slander	mAnahAnia
slash	kAta/ta
slaughter	mAra/harA
slay	vaXA
sleep	so/Tahara
slept	soyA
slew	GumA
slice	Xazsa/cIra
slide	Pisala/sarak/saraka/KIsakA/KisakA/Kisaka/Dalaka
sling	Pefka/latakA
slip	uwAra/uwara/saraka/Pisala/nikAla/le/jA/girA/gira/dAla/Coda/BUla
slit	kAta/cIra
sliver	cIra
slop	Calaka/CalakA/baha
slope	JukA/Juka
slot	samaya-nirXAraNa
slough	uwAra/uwara
slug	alasA
sluice	Xo
slumber	so
slurp	sudaka
smart	tIsa
smash	woda/takarA/mAra
smear	powa
smell	sUzGa/pahacAn/pahacAna/mahaka
smelt	piGala/piGalA/galA
smile	muskarA/camacamA
smite	mAra
smoke	sulagA/pI/BAPa
smoke-out	BagA
smolder	xahak/sulaga
smooth	cikanA/camakA
smote	mArA
smother	xabA/roka/DAzka/buJA
smoulder	sulaga/xahaka
smuggle	waskarIa
smutch	ganxA
snag	cIra/Pata/uXada
snake	refg/refga
snap	tUta/kAta/gurrA
snare	PazsA
snarl	gurrA
snatch	CIna/le
sneeze	CIfka
sniff	sUfGa
snip	kawara/kAta/CAzta
snitch	curA
snivel	pinapinA/ririyA
snort	PataPatA/PunaPunA
snow	barasA
snub	dapata/Jidaka
snuff	buJA/sUfGa
snuffle	nakiyA/sUzGa
soak	soKa/Bigo/Biga
soar	uda
sob	subaka/sisaka
socialise	milanA-jula
socialize	milanA-jula
sock	pIta
sold	becA
solder	JAla
solicit	mAzga/ukasA/PazsA/BadakA
solidify	jamA/jama
solve	sulaJjA
song	gA/cahaka
sort	CAzta/banA/cuna
sound	PElA/nApa/laga/jzAca/jAzcanA/bola/bajA/Azaka
sour	sadA/Pata
source	mazgA
souse	dubA/DAla
sow	bo/ropa
spade	Koxa
spare	xe/bacA
spark	BadakA
sparkle	camaka
spat	Jagada
speak	bola/xarSA/xAga/kaha/BOfka/bawA/baja
spear	Cexa
speed	calA/BagA
spell	bawA
spend	biwA/lagA/gujAra
spew	ugala
spike	milA/Bexa
spill	CalakA/Calaka
spin	GumA/kAwa/Guma/buna
spirit	KisakA
spit	WUka/GuraGurA/baka
splash	Cidaka/BIgo
splatter	CalakA
splay	PElA
splice	joda/bAnX
splinter	cira
split	Pata/PAda/baNta/cIra
spoil	bigAdaxe
spoke	bolA
spook	darA
sport	Kela/xiKA
spot	pA/DUEYNDa/xeKa
spout	JAda
spray	Cidaka
spread	PElA/xe/PEla/lagA/laga/kola/Beja/baDa
spring	uCala/xe/nikAla/lagA/kUxa
sprinkle	Cidaka/CiwarA
sprout	ugA/PUta
spud	Koxa
spurn	TukarA
sputter	KadaKadA
squall	kikiyA/cillA
square	cukA
squash	xabA/TUzsa/picakA/nicoda
squawk	cIKa
squeak	kikiyA/caramarA
squeal	cillA/kikiyA
squeeze	xabA/ugAha/nicoda/Guseda/ENTa
squelch	picakA
squirm	Jempa/wadapa/kasamasA/CatapatA
stab	xabA/Guseda/Bofka
stagger	ladaKadA
staggers	ladaKadA
stall	tAla/roka
stammer	hakalA
stampede	BAga
stanch	roka
stand	saha/raKa/raha/ho
stare	GUra
start	raKa/nikAla/nikala/jalA/BagA
start-up	calA
startle	cOfkA
state	bawA
staunch	roka
stay	raha/ruka
steal	curA
steam-roller	rOnxa
steep	Bigo
steer	paricAlana/calA
stem	roka/jada
step	jA/cala
stew	pakA/nicoda
stick	raKa/Pazsa/joda/Guseda/cUBa/cuBA/cipakA/ataka/cipaka
stifle	xabA
still	SAnwa
stimulate	baDA
sting	xuKa/dasa/ukasA
stir	hila/umada/milA/hilA/calA
stitch	lagA/sI
stock	raKa/lagA
stoke	BadakA/ukasA
stole	curAyA
stomach	saha/pacA
stoop	Juka
stop	ruka/rUka/roka/raha/Bara
store	raKa/jamA
story	bahA
strain	WakA/KIFca/suna
strangle	xabA
strangulate	avaruxXa
stray	BAtaka
stream	laharA/baha
stretch	wAna/PElA/KIFca/baDA
strew	biKera/PElA/CiwarA
stride	lAfGa/lAzGa
strike	takarA/nikAla/mAra/jalA/jala/DAla/banA/baja/sUJa/pada
string	piro/kasa/banXa
strip	uwAra/haTA
stroke	mAra/sahalA
stroll	tahala
struck	mArA
structure	banA
struggle	lada/jUJa
strum	bajA/JafkAra
stub	uKAda/buJA
stuck	cipakAyA
stud	jada
study	xeKa/paDa
stuff	TUsa/milA/kara/Guseda/Bara/TUzsa
stumble	gira
stutter	hakalA/KadaKadA
style	banA
subdivide	praviBAjiwa
subdue	roka
submit	jamA/sOmpa
subscribe	mazgA
subside	Gata
subsidized	sahAyawAprApwa
subtract	GatA
succumb	mara
suck	cUsa/soKa
suffer	uTA/saha
suggest	bawA/bawalA
suit	jazca
sulk	rUTa
summon	bulA/mAzga/pukAra
sung	gAyA
sup	sudaka
support	samBAla
suppose	soca/samaJa/mAna/laga
suppress	xabA/roka
suppurate	pipiyA{mavAxa}
surface	uwarA/caDA
surge	umada
surmise	laga
survey	xarSA/jAzca
survive	jI
suspect	samaJa/laga
suspend	latakA
suss	samaJa
sustain	uTA/samBAla/pahuzca/KA
swab	powa
swaddle	lapeta
swag	ladaKadA
swagger	iTalA
swallow	nigala/xabA/GabarA
swam	wErA
swamp	Bigo
swan	Bataka
swat	mAra
swathe	lapeta/bAzXa
sway	hila/JUla/Juka/hilA
sweep	PEla/JAda/Guma/buhAra/batora/prasarpa
sweet-talk	manA
swell	sUja/uTA/umada/PUla/moda/baDa
swelter	OMsa
swerve	muda/moda
swig	gataka
swill	KafgAla/GUma/GumA
swim	wEra/cakarA
swing	JUla/muda/lataka/laharA/JumA/JulA/Jula/baxala/GUma
swinge	JulasA
swipe	hadapa
swish	sarasarA
switch	baxala
swivel	GUma/GumA
swob	powa
swoop	Japata
tack	lagA/tAzka
tackle	roka/CIna
tag	lagA/CU/bAzXa
tail	kAta
tailor	sI/sila
take	le/xe/uTA/pA/pakada/pada/mAna/lagA/laga/kara/KA/dAla/barawa/banA/apanA
talk	kaha/bola
tangle	ulaJA
tantalise	warasA
tantalize	warasA
tap	KataKatA/nikAla/WirakA/WapaWapA/TakaTakA
tape	lagA/bAzXa
tarry	Tahara
taste	pI/caKa
tattle	gapaSapa
tattoo	goxa
taunt	ciDA
tauten	kasa
teach	siKA/paDA/paD
team	utA/jowa
tear	Pata/PAda/kara
tease	Xuna/cIra/ciDA/Ceda
teeter	ladaKadA/dagamagA
telescope	GatA
tell	bawA/sunA/samaja/paDA/kaha/bola
temper	bajA
tempt	luBA/lalacA
tend	xe/laga/Juka/jA/ho
tender	xe/cukA
tense	wAna/KIca/kasa/gussA
tension	wAna
term	kahalA
terrify	darA/dara
test	paraKa/jAzca
thaw	piGalA/piGala/gala
thieve	curA/curA[anOpacArika]
thin	Cazta
think	soca/vIcAra/samaJa
thrash	pIta/gAha/CatapatA
thread	piro/nikAla/gujara/dAla
threaten	XamakA/darA/cewA
thresh	JiFjoda/gAha/CatapatA
thrive	panapa/PalanA-PUla
throb	Xadaka/kAzpa
throw	Pefka/xe/xeKa/uwAra/sOpa/pahana/paCAda/nikAla/moda/lagA/Kola/JukA/hAra/GumA/girA/gaDa/dAla/Coda/calA/xiKA
thrum	JafkAra
thrust	Tela
thud	XamaXamA
thumb	xeKa/xabA/palata
thump	WapaWapA/Toka/Xadaka
thunder	garaja/dAta
thwart	roka
tick	sila
tickle	guxaguxA/jagA
tidy	sajA
tie	bAzXa/milA/latakA/joda/bazXa
tiff	Jagada
tighten	kasa/wana
till	jowa
tilt	JukA/Juka/dagamagA/Juka[JukAnA]
time	nApa
tincture	rafga
tingle	jala
tinkle	tanatanA/Kanaka
tinsel	sajA
tip	Juka/gira
tipple	pI
tire	WakA/Waka/UbA
titillate	guxaguxA
titivate	sajA
tittivate	sajA
toast	sika/sefka/BUna
toe	mAra
toggle	bAzXa
tolerate	saha
tone	baDA
tongue	bajA
tongue-lashing	Barwsa
tool	sajA/calA
tooth	lagA/PazsA
top	mAra/Daka/CAzta
torment	sawA
toss	Peke/hilA/dUbanA-uwarA/uCAla/hilA[milAnA]
total	joda
tote	Do
totter	ladaKadA
touch	xabA/mAzga/hilA/CUU/CU
touch-at	Tahara
touch-down	uwara
touch-off	xAga
tout	iwarA
tow	GasIta
toy	Kela/tUzga
trace	DUzDa
track	cala
trail	uga/Gisata/hAra
train	ugA/siKA/siKa/baDA
trample	kucala
transfer	uwAra/maDa/sOmpa
transfix	bInXa
transform	GatA/baxala/baDA
transition	Coda
translate	samaJa/baxalanAa/baxala
transmit	PEla/xe
transpire	ho
transport	pahuzcA
trap	rOka/PazsA/PaznA/pakada/dAla/ataka
travel	jA/GUma/cala
tread	kucala
treat	xe/treat/mAne/mAna
tremble	kAzpa/WaraWarA/kzApa/hila/GabarA
trick	TAga/Taga/sajA/bahakA
trick-out	sazvAra
trickle	tapaka/tapakA/risa
trifle-with	Kela
trim	sajA/kAta/CAzta/CAMta
trip	Tumaka/ladaKadA/[yanwra]Kola/Puxaka
triumph	jIwa
trivialize	wucCa`kara
troll	GUma/GumA
trot	cala
trouble	sawA
trumpet	cifGAda
trundle	luDaka
truss	bAzXa
trust	sOpa
try	xeKa/parKa/paraKa/jzAca/jAzca/caKa/AjamA
tuck	sameta/TUzsa/sikoda/lapeta/dAla/miTAI
tug	KIFca
tumble	yahAz-vahAz
tune-in	lagA
turn	xe/sOmpa/raKa/raha/PirA/palata/PAda/muda/moda/moca/lagA/KarAxa/jowa/jA/ho/hatA/GUmA/GUma/GumA/Guma/gira/gaDa/baxala/banA/bana/baja/BagA
turnover	ulata
tussle	ulaJA/lada
tutor	siKA/paDA
twang	JafkAra/tunatunA/tafkAra
tweak	suXAra/maroda
tweet	cahacahA
twine	lapeta/gUzWa/bata
twinkle	camaka/timatimA/JilamilA
twirl	GumA
twist	muda/moda/maroda/kasamasA/gUzWa/GUmA/CatapatA/gUWa/lipata
twit	ciDA
twitch	Padaka/KIFca/Jataka
twitter	cahaka/cahacahA
ulcerate	vraNiwa
unbuckle	Kola
unclasp	Kola
uncork	nikAla
uncover	Kola
uncross	sIXAa
undergo	karA/kara/Jela/gujara
understand	samaJa/jAna
undo	uXeda/Kola/bigAda
undulate	hilora/laharA
unfasten	Kola/Kula
unfold	Kola/PElA/bawalA
unfreeze	piGalA/piGala
unfurl	Kola/PaharA/Kula
unhook	CudA/nikAla
unhorse	uwara
unify	joda
unite	milA/mila
unknot	Kula/Kola
unlash	Kola
unleash	Coda/nikAla
unload	uwAra
unpack	Kola/nikAla/{gaTarI}Kola
unpick	uXeda
unpin	nikAla
unravel	sulaJA/uXeda/uXada/CudA
unravell	sulaJA/uXeda/uXada/CudA
unreel	Kola
unroll	Kula/Kola
unscramble	sulaJA/sulaJa
unscrew	Kula/Kola
unseal	Kola
unsettle	hatA
unsnarl	sulaJA
unstrap	Kola
unstuff	Kola
untack	uXeda
untangle	sulaJA/sulaJa/CudA
unthaw	piGalA/piGala
untie	Kola/uwAra
untwine	Kola
unveil	xiKA/bawA/Kola
unwind	uXeda/Kula/Kola
unwrap	Kola
unzip	Kola
up	uTa/baDA/uTA/caDA
uphold	samBala
uplift	uTA
uprise	uTa/A
uproot	beGara
upset	niSicala
urge	ukasA/hAfka/BadakA
use	prayukwa
usurp	hadapa
utter	nikAla/kaha/calA/bola
vacate	Coda
vacillate	hicakicA/GatanA-baDa
vacuum	nirvAwa/KAlIpana
vamp	luBA/gaDa
vanquish	jIwa
vary	baxala
veil	Daka
vellicate	guxaguxA
veneer	mulammA
verge	Juka
verify	jAzca
vet	jAzca
vex	KijA
vibrate	kAzpa/hicakicA/gUzja
view	xeKa/samaJa/paraKa
violate	woda
visit	xeKane/xeKa/Tahara/jA/A
visualise	xeKa
visualize	xeKa
vocalise	gA
vocalize	gA
vociferate	cillA
void	nikAla
volunteer	kaha
vomit	Coda
vow	vAxA
wad	Bara
waffle	hicakicA
wag	hilA/hila
wage	kara
waggle	hilA
wait	Tahara
waive	Coda
wake	jagA/jAga
waken	jagA/uTA/jAga
walk	tahalA/nApa/cala/A
wallow	lota/ladaKadA/AwmaxayA
wander	GUma/Bataka
wane	Gata
want	cAha/cAhiee
warble	kUja/gA
warm	wapA
warn	bawalA
warp	moda
was	WA
wash	Xo/Xula/ulIca/paKAra/nahA
watch	xeKa
water	sIFca
waul	kikiyA
wave	laharA/kara/hilA/GumA
waver	laharA/ladaKadA/hicakicA/GatanA-baDa/dagamagA
wawl	kikiyA
wax	baDa
wear	raKa/pahana/ho/banA
weary	WakA
weather	baxala
weave	buna/kara/gUzWa
weep	ro/baha
weep_verbal	ro
weigh	wola/wOla/uTA/nApa
weighed-anchor	sahayoga/sahArA
weight	lagA
weld	joda/JAla
well	umada
welter	lota/dUbanA-uwarA
were	We
whack	hissA
wheedle	manA
wheel	uda/Tela/moda/GumA
whicker	hinahinA
whimper	TinaTinA/ririyA
whine	ririyA/pinapinA/karAha
whinny	hinahinA
whip	PeNtana/curA/PeNta
whirl	GUma
whisk	PeNta
whisper	sarasarA/PusaPusA
whistle	sanasanA
whitewash	CipA
whittle	CIla/kAta
whiz	sanasanA
whoop	TaTaka/lalakAra/cillA
widen	baDA
wield	PirA/calA
wiggle	kulabulA/hila/CatapatA
will	hogA/cAha
wilt	murJA/kumhalA
win	jIwa/pA/mila
wind	hazPA/lapeta/kara/GUmA/moda
wing	udA/uda/kara
wink	timatimA
winkle	timatimA/camaka
winnow	Pataka/udA/paCora/cuna
winter	cara
wipe	poFCa/mitA/hatA/gira
wire	joda
wish	cAha
withdraw	hatA
wither	murJA/muraJA/kumhalA
withhold	kAta
witness	xeK/xeKa/kara
wobble	laraja/ladaKadA/kAzpa/dagamagA
wolf	Bakosa
wonder	Bataka
work	sulJA/mila/lA/kara/joda/Jataka/GumA/gAzTa/DAla/calA/cala/buna/banA
worm	pA/kasamasA
worry	ragada/cInWa
worst	jIwa
would	hogA
wrap	lapeta/Daka/CipA
wrawl	cillA
wreak	kara/ho
wreath	Gera
wreathe	AcCAxiwa/Gera
wrench	maroda/mala
wrestle	lada/kasamasA/jUJa/CatapatA
wriggle	kasamasA/CatapatA
wring	maroda/ugAha/nicoda/mala/ENTa
wrinkle	sikoda/gIFja
write	liKa/raca/Beja/banA
writhe	karAha/kasamasA
wrought	lA
yack	bawiyA
yammer	vilapa/ririyA/pinapinA/cillA/badabadA
yap	badabadA
yaw	vicala
yawp	ririyA/pinapinA
yearn	warasa/wadapa
yell	cillA/cIKa
yelp	cIKa
yen	warasa/lalaka
yield	xe/tuta/Coda/baxala/bawA
yoke	jowa/nAWa
yowl	cillA/huA/cIKa
zero	bETA
