avamAniwa_kara	avamAniwa
saMkRipwa_kara	saMkRipwa
apaharaNa_kara	apaharaNa
GqNA_kara	GqNA
pAlana_kara	pAlana
SapaWa_wyAga_kara	SapaWa_wyAga
unmUlana_kara	unmUlana_kara
garBapAwa_karavAne_vAlA	garBapAwa_karavAne_vAlA
saMkRepaNa_kara	saMkRepaNa
raxxa_kara	raxxa
vimukwa_karanA/kRamA_kara	vimukwa_karanA/kRamA
grahaNa_kara	grahaNa
avaSoRiwa_kara	avaSoRiwa
parahejZa_karanA/se_xUra_raha	parahejZa_karanA/se_xUra_rahanA
saMkRipwa_banAnA/saMkRepa_kara	saMkRipwa_banAnA/saMkRepa
xurvyavahAra_kara	xurvyavahAra
svIkAra_kara	svIkAra
svara_uccAraNa_kara	svara_uccAraNa
svIkAra_kara	svIkAra
vAha_vAha_kara	vAha_vAha
samAviRta_kara	samAviRta_kara
samAyojiwa_kara	samAyojiwa
sahAyawA_kara	sahAyawA
saMgawa_kara	saMgawa
pUrA_kara	pUrA
saMboXana_kara	saMboXana
prawyAyiwa_kara	prawyAyiwa
saMcaya_kara	saMcaya
xarxa_kara	xarxa
pUrA_kara	pUrA
amla_kara	amla
svIkAra_kara	svIkAra
avagawa_kara	avagawa_kara
binA_viroXa_ke_svIkAra_kara	binA_viroXa_ke_svIkAra
arjana_kara	arjana
xoRa_mukwa_kara	xoRa_mukwa
kAma_kara	kAma
aBinaya_kara	aBinaya
kAnUnI_kAryavAhI_karane_yogya	kAnUnI_kAryavAhI_karane_yogya
kAnUnI_kAryavAhI_karane_yogya	kAnUnI_kAryavAhI_karane_yogya
sakriya_kara	sakriya
paricAliwa_kara	paricAliwa
ke_liE_rUpAMwariwa_kara	ke_liE_rUpAMwariwa
nivexana_kara	nivexana
vAkiPa_kara	vAkiPa_kara
pAlana_kara	pAlana
pAlana_karwA/anucara	pAlana_karwA/anucara
sWagiwa_kara	sWagiwa
sWAnAMwariwa_kara	sWAnAMwariwa_kara
nirNaya_kara	nirNaya_kara
mukaxame_kA_nirNaya_kara	mukaxame_kA_nirNaya
vyavasWiwa_kara	vyavasWiwa
barAbara_kara	barAbara
binA_wEyArI_ke_bola	binA_wEyArI_ke_bola
prabanXa_karanA/praSAsana_kara	prabanXa_karanA/praSAsana
praSaMsA_kara	praSaMsA
praSaMsaka/prema_karane_vAlA	praSaMsaka/prema_karane_vAlA
svIkAra_karane_yogya	svIkAra_karane_yogya
svIkAra_kara	svIkAra
BarwI_kara	BarwI
svIkAra_karawe_hue	svIkAra_karawe_hue
grahaNa_kara	grahaNa
svIkAra_kara	svIkAra
svIkAra_kara	svIkAra_kara
ArAXanA_kara	ArAXanA
bahuwa_pasanxa_kara	bahuwa_pasanxa
milAvata_kara	milAvata_kara
pragawi_kara	pragawi
niSciwa_samaya_se_pUrva_kara	niSciwa_samaya_se_pUrva
sUciwa_kara	sUciwa
vicAra_karake	vicAra_karake
vakAlawa_kara	vakAlawa
bahAnA_kara	bahAnA
sahabaxXa_kara	sahabaxXa
pramANiwa_karanA/xqDZawApurvaka_kaha	pramANiwa_karanA/xqDZawApurvaka_kahanA
saMyukwa_karanA/jodZa	saMyukwa_karanA/jodZanA
vahana_kara_pA	vahana_kara_pAnA
apamAniwa_kara	apamAniwa
prawiniXi	prawiniXi
uwwejiwa_kara	uwwejiwa
kroXiwa_kara	kroXiwa
saMgraha_kara	saMgraha
AkramaNa_karwA	AkramaNa_karwA
maxaxa_kara	maxaxa
lakRiwa_kara	lakRiwa
vyakwa_kara	vyakwa
havAI_karmI	havAI_karmI
havAI_jahAja_xvArA_maxaxa_kara	havAI_jahAja_xvArA_maxaxa
musIbawa	musIbawa
vimuKa_kara	vimuKa
sammiliwa_kara	sammiliwa
xabA	xabAnA
kama_kara	kama
nirXAriwa_kara	nirXAriwa
svIkAra_karanA/mAna_le	svIkAra_karanA/mAna_lenA
saMkewa_kara	saMkewa
samabaxXa_kara	samabaxXa
sAmAnya_praxarSana_karane_vAlA	sAmAnya_praxarSana_karane_vAlA
bArI-bArI_se_kara	bArI-bArI_se
vEkalpika_UrjA	vEkalpika_UrjA
saMciwa_kara	saMciwa
cakiwa_kara	cakiwa
saMSoXana_kara	saMSoXana
kAta	kAtanA
manoraMjana_kara	manoraMjana
cewanASUnya_karane_vAlA/behoMSa_karane_vAlA	cewanASUnya_karane_vAlA/behoMSa_karane_vAlA
cewanASUnya_kara	cewanASUnya
Sabxa_baxalakara_kara_nayA_Sabxa_banA	Sabxa_baxalakara_kara_nayA_Sabxa_banAnA
viSleRaNa_kara	viSleRaNa
kroXiwa_kara	kroXiwa
iMglenada_ora_vahAz_kI_vaswuoM_ko_naParawa_karane_vAlA	iMglenada_ora_vahAz_kI_vaswuoM_ko_naParawa_karane_vAlA
sammohiwa_karane_kI_Sakwi	sammohiwa_karane_kI_Sakwi
jIvana_saMcAra_karanA/prANa_dAla	jIvana_saMcAra_karanA/prANa_dAlanA
sAWa_jodanA/saMlagna_kara	sAWa_jodanA/saMlagna
kabje_meM_kara	kabje_meM
vinASa_karanA/mitAnAú	vinASa_karanA/mitAnAú
tippaNI_karanA/tIkA_karake_samaJA	tippaNI_karanA/tIkA_karake_samaJAnA
GoRaNA_kara	GoRaNA_kara
pareSAna_kara	pareSAna
raxxa_karanA/niRPala_kara	raxxa_karanA/niRPala
õ?lopa?karanA/SUnya_kara	õ?lopa?karanA/SUnya
viroXa_kara	viroXa
pUrva-xinAMkiwa_kara	pUrva-xinAMkiwa
SrqMgikA	SrqMgikA
pUrvAnumAna_kara	pUrvAnumAna
pUrvAnumAna_karawA_huA	pUrvAnumAna_karawA_huA
praBAva_ko_nyUna_karane_vAlA	praBAva_ko_nyUna_karane_vAlA
cinwA_karanevAlA	cinwA_karanevAlA
vismiwa_kara_xe	vismiwa_kara_xenA
apIla_karanA/yAcanA_kara	apIla_karanA/yAcanA
punarvicAra_ke_liye_prArWanA_kara	punarvicAra_ke_liye_prArWanA
yAcanA_karawe_hue	yAcanA_karawe_hue
yAcanA_karawe_hue	yAcanA_karawe_hue
saMwuRta_kara	saMwuRta
apIla_karane_vAlA/punanyArWI/punarvAxI	apIla_karane_vAlA/punanyArWI/punarvAxI
wAlI_bajA_kara_praSaMsA_kara	wAlI_bajA_kara_praSaMsA
sarAhanA_kara	sarAhanA
lAgU_kara	lAgU_kara
lAgU_kara	lAgU
niyukwa_kara	niyukwa
niyawa_kara	niyawa
saMviBAjiwa_kara	saMviBAjiwa
_sAmanA_karanA,_mukAbalA_kara	_sAmanA_karanA,_mukAbalA
mUlyAMkana_kara	mUlyAMkana
giraPwAra_kara	giraPwAra
sUciwa_kara	sUciwa
anumoxana_kara	anumoxana
pasanxa_kara	pasanxa
maXyasWawA_karanA/paMca_PEsalA_xenA/nirNaya_kara	maXyasWawA_karanA/paMca_PEsalA_xenA/nirNaya
bahasa_kara	bahasa
pramANiwa_kara	pramANiwa
Saswra_yukwa_kara	Saswra_yukwa
haWiyAralesa_kara	haWiyAralesa
kuCa_nahIM_karawe_hue	kuCa_nahIM_karawe_hue
GUma_kara	GUma_kara
uwwejiwa_kara	uwwejiwa
prabanXa_kara	prabanXa
giraPwAra_karanA/pakadZa	giraPwAra_karanA/pakadZanA
AkarRiwa_kara	AkarRiwa
jAzca_kara_pawA_lagA	jAzca_kara_pawA_lagAnA
AropaNa_kara	AropaNa
raxxa_kara	raxxa
ha'XvanI_se_uccAraNa_kara	ha'XvanI_se_uccAraNa
hawyA_kara	hawyA
hamalA_karanA/AkramaNa_kara	hamalA_karanA/AkramaNa
paraKa_kara	paraKa
ekawriwa_kara	ekawriwa_kara
ikatTA_kara	ikatTA
Azkalana_karanevAlA	Azkalana_karanevAlA
niSciwa_kara	niSciwa
niyukwa_kara	niyukwa
AwmasAwa_kara	AwmasAwa
sahAyawA_karanA/maxaxa_kara	sahAyawA_karanA/maxaxa
SAnwa_kara	SAnwa
kalpanA_karanA/mAna_le	kalpanA_karanA/mAna_lenA
rUpa_XAraNa_kara	rUpa_XAraNa
kalpanA_kara_le	kalpanA_kara_lenA
aMgIkAra_kara	aMgIkAra
cakiwa_kara	cakiwa
cakiwa_kara	cakiwa
anwarikRa_yAna_me_prayANa_karane_vAlA	anwarikRa_yAna_me_prayANa_karane_vAlA
prAyaSciwa_kara	prAyaSciwa
nawWI_kara	nawWI
kurka_kara	kurka
XAvA_kara	XAvA
AkramaNa_kara	AkramaNa
prApwa_kara	prApwa
prayAsa_kara	prayAsa
sevA_kara	sevA
kama_kara	kama
haswAkRara_kara	haswAkRara
AkarRiwa_kara	AkarRiwa
nIlAma_kara	nIlAma
nIlAma_karane_vAlA	nIlAma_karane_vAlA
pramANiwa_kara	pramANiwa
racanA_kara	racanA
vAxA_kara	vAxA
vismayapUrNa_Axara_uwpanna_kara	vismayapUrNa_Axara_uwpanna
kAta	kAta
buxabuxAnA_karanevAlA	buxabuxAnA_karanevAlA
ke_sAWa_bacce_jEsA_vyavahAra_kara	ke_sAWa_bacce_jEsA_vyavahAra
bacce_kI_xeKaBAla_kara	bacce_kI_xeKaBAla
bacce_kI_xeKaBAla_karanevAlA	bacce_kI_xeKaBAla_karanevAlA
pITa_pICe_niMxA_kara	pITa_pICe_niMxA
palata_kara_javAba_xe	palata_kara_javAba_xenA
XamAkexAra_AGAwa_kara	XamAkexAra_AGAwa
kisI_kI_ArWika_sahAyawA_kara	kisI_kI_ArWika_sahAyawA
xillagI_kara	xillagI
argalA_se_baMxa_kara	argalA_se_baMxa
prawibaMXiwa_kara	prawibaMXiwa
ko_CodZa_kara	ko_CodZa_kara
nirvaswra_kara	nirvaswra
prakata_kara	prakata
mola-BAva_kara	mola-BAva
vaswu-vinimaya_kara	vaswu-vinimaya
AXAriwa_kara	AXAriwa
XUpa_mez_garama_karanA_yA_sezka	XUpa_mez_garama_karanA_yA_sezkanA
ballebAjZI_kara	ballebAjZI
benata_se_vAra_kara	benata_se_vAra
XAraNa_kara	XAraNa
barxASwa_kara	barxASwa
vahana_kara	vahana
vAra_kara	vAra
kadZI_mehanawa_kara	kadZI_mehanawa
saMkewa_kara	saMkewa
saMBoga_kara	saMBoga
AvAjZa_kara	AvAjZa
xoswI_kara	xoswI
yAcanA_kara	yAcanA_kara
prArWanA_kara	prArWanA
uwpanna_kara	uwpanna
kaMgAla_kara_xe	kaMgAla_kara_xenA
prAramBa_kara	prAramBa
prAramBa_karane_vAlA	prAramBa_karane_vAlA
xene_meM_saMkoca_kara	xene_meM_saMkoca
kisI_ko_KuSa_kara	kisI_ko_KuSa
vyavahAra_kara	vyavahAra
xerI_kara	xerI
JUTA_kara	JUTA
viSvAsa_kara	viSvAsa
CotA_kara	CotA
xuKa_prakata_kara	xuKa_prakata
BalA_kara	BalA
vasIyawa_kara	vasIyawa
CIna_le	CIna_lenA
praxAna_kara	praxAna
viSvAsaGAwa_kara	viSvAsaGAwa
hErAna_kara	hErAna
jAxU_kara	jAxU
JagadZA_kara	JagadZA
blEkamela_kara	blEkamela_kara
ISvaraninxA_kara	ISvaraninxA
ujalA_karanA/niKAra	ujalA_karanA/niKAranA
milAnA/miSraNa_kara	milAnA/miSraNa
anXA_kara	anXA
AzKa_banxa_kara_xenA/BatakA_xe	AzKa_banxa_kara_xenA/BatakA_xenA
rokanA/banxa_kara	rokanA/banxa
nAkAbaMxI_kara	nAkAbaMxI
CIlanA/2.xAgaxAra_karanA/XabbA_lagA	CIlanA/2.xAgaxAra_karanA/XabbA_lagAnA
visPota_kara	visPota
kroXa_kara	kroXa
badA_kara	badA
ninxA_kara	ninxA
BArI_BUla_karane_vAlA	BArI_BUla_karane_vAlA
XuMXalA_kara	XuMXalA
nOkA-vihAra_kara	nOkA-vihAra
jahAjZa_ke_JaNdoM_Axi_kI_xeKaBAla_karanevAlA_aXikArI	jahAjZa_ke_JaNdoM_Axi_kI_xeKaBAla_karanevAlA_aXikArI
Upara_nIce_kara	Upara_nIce_kara
BaviRya_sUciwa_kara	BaviRya_sUciwa
lambI_cOdZI_bAwacIwa_kara	lambI_cOdZI_bAwacIwa
buka_kara	buka
Cexa_karanA_yA_Bexa	Cexa_karanA_yA_BexanA
prabanXa_karanA/xeKaBAla_kara	prabanXa_karanA/xeKaBAla
waMga_kara	waMga
bowala_meM_banxa_karanA/baMXana_meM_raKa	bowala_meM_banxa_karanA/baMXana_meM_raKanA
bakse_meM_banxa_kara	bakse_meM_banxa
bahiRkAra_kara	bahiRkAra
xqDZa_kara	xqDZa
koRTa_meM_banxa_kara	koRTa_meM_banxa
sAmanA_karanA/lalakAra	sAmanA_karanA/lalakAranA
xarAra_kara	xarAra
BaMga_kara	BaMga
kama_kara	kama
pExA_kara	pExA_kara
ujjavala_kara_xe	ujjavala_kara_xenA
upasWApiwa_kara	upasWApiwa_kara
carcA_kara	carcA
cAroM_ora/PeMka_kara	cAroM_ora/PeMka_kara
prasAriwa_kara	prasAriwa
cOdZA_kara	cOdZA
garma_kara	garma
cinwA_kara	cinwA
bruSa_se_JAdanA_yA_sAPa_kara	bruSa_se_JAdanA_yA_sAPa
anaxeKA_kara	anaxeKA
bruSa_se_sAPa_kara	bruSa_se_sAPa
punaH_aByAsa_kara	punaH_aByAsa
inakAra_kara	inakAra
XakkA_mukkI_kara	XakkA_mukkI
pareSAna_kara	pareSAna
baga_kara	baga
nirmANa_kara	nirmANa
sWApiwa_karanA/bala_xe	sWApiwa_karanA/bala_xenA
GapalA_kara	GapalA
corI_kara	corI_kara
xaPana_karanA/mittI_xe	xaPana_karanA/mittI_xenA
galA_GoMta_kara_mAra	galA_GoMta_kara_mAranA
parihAsa_kara	parihAsa
nirxayawA_se_vaXa_kara	nirxayawA_se_vaXa
banxa_kara	banxa
gaNanA_kara	gaNanA_kara
banxa_kara	banxa
nimaMwriwa_kara	nimaMwriwa
telIPona_kara	telIPona
SAnwa_kara	SAnwa
CaxamAvaraNa_kara	CaxamAvaraNa
raxxa_kara	raxxa_kara
raxxa_kara	raxxa
paraganoM_meM_viBAjiwa_kara	paraganoM_meM_viBAjiwa
newqwva_kara	newqwva
kExa_karanevAlA	kExa_karanevAlA
paravAha_karanA/cinwA_kara	paravAha_karanA/cinwA
praSaMsAgAna_karanA/AnanxagIwa_gA	praSaMsAgAna_karanA/AnanxagIwa_gAnA
KUba_maxyapAna_kara	KUba_maxyapAna
CotI_wucCa_bAwoM_kI_SikAyawa_kara	CotI_wucCa_bAwoM_kI_SikAyawa
praBAviwa_kara	praBAviwa
smaraNa_kara	smaraNa
bahasa_kara	bahasa
pUrNa_kara	pUrNa
kaTina_samaya_meM_kisI_kI_sahAyawA_kara	kaTina_samaya_meM_kisI_kI_sahAyawA
kAta_kara_ciwra_banA	kAta_kara_ciwra_banAnA
paxacyuwa_karanA/nikAla_xe	paxacyuwa_karanA/nikAla_xenA
napuMsaka_kara	napuMsaka
kAraNa_honA/uwpanna_kara	kAraNa_honA/uwpanna
sAvaXAna_kara	sAvaXAna
kAta_CAzta_kara	kAta_CAzta
niMxA_kara	niMxA
kenxrIyakaraNa_kara	kenxrIyakaraNa
pramANiwa_kara	pramANiwa
hazsI_meM_KijAnA/waMga_kara	hazsI_meM_KijAnA/waMga
japa_kara	japa
japa_karanA/alApa	japa_karanA/alApanA
cOkasI_karanevAlI_swrI	cOkasI_karanevAlI_swrI
cOkasI_kara	cOkasI
cariwra_ciwraNa_kara	cariwra_ciwraNa
uwwejiwa_karanA/ho	uwwejiwa_karanA/honA
bijalI_saMcaya_karane_ke_yaMwra_meM_bijalI_Bara	bijalI_saMcaya_karane_ke_yaMwra_meM_bijalI_BaranA
mohiwa_kara	mohiwa
pICA_kara	pICA
pICA_kara	pICA
nigraha_kara	nigraha
xaNda_xenA/wAdZanA_kara	xaNda_xenA/wAdZanA
gapaSapa_kara	gapaSapa
bakabaka_kara	bakabaka
kapata_kara	kapata
saMyamiwa_kara	saMyamiwa
nAma_xarja_kara	nAma_xarja
nAma_xarja_kara	nAma_xarja
jAzca_kara	jAzca
sawya_kI_jAzca_kara	sawya_kI_jAzca
bila_Barakara_jagaha_KAlI_kara	bila_Barakara_jagaha_KAlI
jAzca_kara	jAzca
jAzca_kara	jAzca_kara
harRiwa_kara	harRiwa
snehapUrvaka_raKanA/XyAna_kara	snehapUrvaka_raKanA/XyAna
JaMkAra_kara	JaMkAra
cUz-cUz_karanA/cIM-cIM_kara	cUz-cUz_karanA/cIM-cIM
gapaSapa_kara	gapaSapa
besuXa_karane_kI_ORaXi/kloroPArma	besuXa_karane_kI_ORaXi/kloroPArma
nyAyaXISa_xvArA_mukaxxamA_sunane_hewu_kisI_sWAna_kA_niyamiwa_BramaNa_kara	nyAyaXISa_xvArA_mukaxxamA_sunane_hewu_kisI_sWAna_kA_niyamiwa_BramaNa
gawiroXa_pExA_kara	gawiroXa_pExA
SaharIkaraNa_karanA2	SaharIkaraNa_karanA2
asEnika_karmacArI	asEnika_karmacArI
karkaSa_Sabxa_kara	karkaSa_Sabxa
AcCAxiwa_kara	AcCAxiwa
xAvA_kara	xAvA
kolAhala_karanA/cillA	kolAhala_karanA/cillAnA
spaRta_kara	spaRta
vargIkaraNa_kara	vargIkaraNa
SAswrIya_praNAlI_kA_anusarana_karanevAlA	SAswrIya_praNAlI_kA_anusarana_karanevAlA
vargIkqwa_kara	vargIkqwa
KadZaKadZa_kI_AvAjZa_kara	KadZaKadZa_kI_AvAjZa
klAstroPobiyA	klAstroPobiyA
banxa_jagaha_meM_Gutana_mahasUsa_karanevAlA	banxa_jagaha_meM_Gutana_mahasUsa_karanevAlA
niyamoM_kA_pAlana_karawe_hue	niyamoM_kA_pAlana_karawe_hue
sAPa_kara	sAPa
sAPa_kara	sAPa
corI_kara	corI
sAPa_karane_vAlA	sAPa_karane_vAlA
SoXana_kara	SoXana
SoXana_karanevAlA	SoXana_karanevAlA
sAPa_kara	sAPa
nikAsa_kara	nikAsa
cukawA_kara	cukawA
pAra_kara	pAra
xviKaMdiwa_kara	xviKaMdiwa
klika_kara	klika_kara
klika_kara	klika_kara
ArohaNa_kara	ArohaNa
unnawi_kara	unnawi
prApwa_kara_le	prApwa_kara_lenA
tana-tana_AvAjZa_kara	tana-tana_AvAjZa
Xvani_kara	Xvani
banxa_kara	banxa
AliMgana_kara	AliMgana
AliMgana_kara	AliMgana
AliMgana_kara	AliMgana
samApwa_kara	samApwa
banxa_kara	banxa
mUrKawApUrNa_vyavahAra_kara	mUrKawApUrNa_vyavahAra
kudZakudZAne_kI_AvAjZa_kara	kudZakudZAne_kI_AvAjZa
Xama-Xama_karane_kA_calana	Xama-Xama_karane_kA_calana
aswa-vyaswa_kara	aswa-vyaswa
marammawa_kara	marammawa
KadZA_kara	KadZA
sAvaXAnI_se_xeKaBAla_kara	sAvaXAnI_se_xeKaBAla
majabUra_kara	majabUra
jabaraxaswI_kara	jabaraxaswI
gahana_cinwana_kara	gahana_cinwana
PAyaxA_kara	PAyaxA
sahayoga_kara	sahayoga
xeSaxroha_kara	xeSaxroha
giraPwAra_kara	giraPwAra
saBI_jagaha_se_sUcanA_ekawra_kara	saBI_jagaha_se_sUcanA_ekawra
saMgrahIwa_kara	saMgrahIwa
caMxA_ikatTA_kara	caMxA_ikatTA
saMgraha_karane_yogya	saMgraha_karane_yogya
sAmUhika_kara_xe	sAmUhika_kara_xenA
koyale_kI_KAna_me_kAma_karanevAlA	koyale_kI_KAna_me_kAma_karanevAlA
sAWa_meM_prayoga_kara	sAWa_meM_prayoga
svayaM_se_bAwa_kara	svayaM_se_bAwa
kaMGI_kara	kaMGI
viroXa_kara	viroXa
yAwrA_kara	yAwrA
eka_niSciwa_sWAna_gqhaNa_kara	eka_niSciwa_sWAna_gqhaNa
praSna_meM_prayoga_kara	praSna_meM_prayoga
aBinaya_kara	aBinaya
1kAmowwApa_kara	1kAmowwApa
prowsAhana_kara	prowsAhana
bahuwa_ninxA_kara	bahuwa_ninxA
AkramaNa_kara	AkramaNa
sahAyawA_praxAna_kara	sahAyawA_praxAna
SAsana_kara	SAsana
kisI_uwsava_xvArA_smaraNa_karanA/manA	kisI_uwsava_xvArA_smaraNa_karanA/manAnA
praSaMsA_kara	praSaMsA
barAbara_kara	barAbara
tIkA-tippaNI_kara	tIkA-tippaNI
kisI_para_xayA_kara	kisI_para_xayA
aXikAra_xenA/niyukwa_kara	aXikAra_xenA/niyukwa
samarpaNa_kara	samarpaNa
vAxA_kara	vAxA
bAwacIwa_karane_evaM_samparka_raKane_ke_IcCuka	bAwacIwa_karane_evaM_samparka_raKane_ke_IcCuka
yAwrA_kara	yAwrA
rUpAMwariwa_kara	rUpAMwariwa
wulanA_kara	wulanA
vivaSa_kara	vivaSa
barAbarI_kara	barAbarI
saMkalana_karanA/saMgraha_kara	saMkalana_karanA/saMgraha
SikAyawa_kara	SikAyawa
pUrA_kara	pUrA
praSaMsA_kara	praSaMsA
anupAlana_kara	anupAlana
pAlana_kara	pAlana
XErya_XAraNa_kara	XErya_XAraNa
saMkRepa_kara	saMkRepa
samAviRta_karanA/sammiliwa_kara	samAviRta_karanA/sammiliwa
samaJOwA_kara	samaJOwA
gaNanA_kara	gaNanA
kalpanA_kara	kalpanA
samAhqwa_kara	samAhqwa
cinwiwa_kara	cinwiwa
SAnwa_kara	SAnwa
pUrA_kara	pUrA
niSciwa_kara	niSciwa
anumAna_kara	anumAna
milA_kara_pakA	milA_kara_pakAnA
CotA_kara	CotA
oCA_kAma_karane_ke_lie_rAjZI_ho	oCA_kAma_karane_ke_lie_rAjZI_ho
Soka_prakata_kara	Soka_prakata_kara
mAPa_karanA/CodZa_xenA/XyAna_na_xe	mAPa_karanA/CodZa_xenA/XyAna_na_xenA
sAWa_meM_kAma_karanevAlA	sAWa_meM_kAma_karanevAlA
parAmarSa_kara	parAmarSa
praxAna_kara	praxAna
xoRa_svIkAra_kara	xoRa_svIkAra_kara
aMgIkAra_kara	aMgIkAra
sImAbaxXa_kara	sImAbaxXa
pakkA_kara	pakkA
jZabwa_kara	jZabwa
viroXa_kara	viroXa
ekamela_kara	ekamela
hakkA-bakkA_kara	hakkA-bakkA
sAmanA_kara	sAmanA
anumAna_kara	anumAna
jAxU_kara	jAxU
kisI_ke_sAWa_milakara_avEXa_kArya_kara	kisI_ke_sAWa_milakara_avEXa_kArya
upekRA_kara	upekRA
kisI_ke_sAWa_milakara_avEXa_kArya_kara	kisI_ke_sAWa_milakara_avEXa_kArya
arWa_sUciwa_kara	arWa_sUciwa
arpaNa_kara	arpaNa
vicAra_kara	vicAra
XyAna_meM_raKa_kara	XyAna_meM_raKa_kara
arpaNa_kara	arpaNa
mela_kara	mela
vivaSa_kara	vivaSa
kAma_meM_lAnA/vyaya_kara	kAma_meM_lAnA/vyaya
pUrA_kara	pUrA
samparka_sWApiwa_kara	samparka_sWApiwa
atAnA/XAraNa_kara	atAnA/XAraNa
sammiliwa_kara	sammiliwa
aSuxXa_kara	aSuxXa
vicAra_kara	vicAra
vivAxa_kara	vivAxa
mukAbalA_karane_vAlA	mukAbalA_karane_vAlA
sanwuRta_kara	sanwuRta
mukAbalA_kara	mukAbalA
warka_kara	warka
karAra_kara	karAra
viroXa_kara	viroXa
prawivAxa_kara	prawivAxa
vyawireka_kara	vyawireka
kAnUna_kA_ullaMGana_kara	kAnUna_kA_ullaMGana
sahAyawA_karanA/caMxA_xe	sahAyawA_karanA/caMxA_xenA
KaNdana_kara	KaNdana
svAsWyalABa_kara	svAsWyalABa
Ayojana_kara	Ayojana
ekawra_kara	ekawra
vArwAlApa_kara	vArwAlApa
Xarma_parivarwana_kara	Xarma_parivarwana
viSvAsa_karavA	viSvAsa_karavA
kUM_kUM_kara	kUM_kUM
TaNdA_kara	TaNdA
kroXa_TaNdA_kara	kroXa_TaNdA
xadZabe_meM_baMxa_kara	xadZabe_meM_baMxa
marammawa_karanA/jodZa_xe	marammawa_karanA/jodZa_xenA
saMyojana_kara	saMyojana
sAmanA_kara	sAmanA
saMyugmana_kara	saMyugmana
aBimAnI_vyakwi_kA_nakala_kara	aBimAnI_vyakwi_kA_nakala
nakala_karane_vAlA	nakala_karane_vAlA
AScarya_prakata_karane_vAlI_Xvani	AScarya_prakata_karane_vAlI_Xvani
peya	peya
kama_iswemAla_karane_vAlA	kama_iswemAla_karane_vAlA
apamqwyu_kA_kAraNa_jFAwa_karanevAlA_aPZasara	apamqwyu_kA_kAraNa_jFAwa_karanevAlA_aPZasara
TIka_karanA/SoXa	TIka_karanA/SoXanA
saMSoXana/prawikAra_karane_vAlA	saMSoXana/prawikAra_karane_vAlA
puRta_kara	puRta
puRta_karane_vAlA	puRta_karane_vAlA
niyamoM_kA_anusaraNa_na_karanevAlA	niyamoM_kA_anusaraNa_na_karanevAlA
BraRta_kara	BraRta_kara
KUba_lAdZa_pyAra_kara	KUba_lAdZa_pyAra
mAna_kara	mAna
BarosA_kara	BarosA
anumoxana_kara	anumoxana
viroXa_kara	viroXa
prawikriyA_kara	prawikriyA
prawyAkramaNa_kara	prawyAkramaNa
wulya_BAra_kara	wulya_BAra
jAlasAjZI_kara	jAlasAjZI
viSeRa_guwpacara_sevA_jo_Sawru_ke_guwpacaroM_ke_prayAsoM_ko_viPala_kara_xewI_hE	viSeRa_guwpacara_sevA_jo_Sawru_ke_guwpacaroM_ke_prayAsoM_ko_viPala_kara_xewI_hE
AcCAxiwa_karanA/DAzka	AcCAxiwa_karanA/DAzkanA
waya_kara	waya
kisI_ke_sWAna_para_kArya_kara	kisI_ke_sWAna_para_kArya
loBa_kara	loBa
XamAkA_kara	XamAkA
kAma_karanA_banxa_kara_xe	kAma_karanA_banxa_kara_xenA
lAlasA_karanA/aBilARA_kara	lAlasA_karanA/aBilARA
yAcanA_kara	yAcanA
racanA/sqRti_karanA/uwpanna_kara	racanA/sqRti_karanA/uwpanna
nirmANa_kara	nirmANa
sqjana_kara	sqjana
sqjanAwmaka_nirmANa_karane_kI_Sakwi_vAlA	sqjanAwmaka_nirmANa_karane_kI_Sakwi_vAlA
kisI_KAwe_meM_jamA_kara	kisI_KAwe_meM_jamA
UzcA_howe_jAnA/pragawi_karawe_raha	UzcA_howe_jAnA/pragawi_karawe_rahanA
nakala_kara	nakala
sARtAMga_praNAma_kara	sARtAMga_praNAma
apAhija_kara	apAhija
AlocanA_kara	AlocanA
corI_karanA/XoKA_xe	corI_karanA/XoKA_xenA
uwpanna_karanA/xe	uwpanna_karanA/xenA
pAra_uwAranA/pAra_kara	pAra_uwAranA/pAra
rokanA/viroXa_kara	rokanA/viroXa
saMkaraNa_kara	saMkaraNa
viviXa_prakAra_se_jAzca_kara	viviXa_prakAra_se_jAzca
krOYsa_karenta	krOYsa_karenta
jiraha_kara	jiraha
para-saMsecana_kara	para-saMsecana
AdZI-wiraCI_lakIroM_se_reKAMkana_kara	AdZI-wiraCI_lakIroM_se_reKAMkana
jiraha_kara	jiraha
kAzva_kAzva_karanA/kukurU_kUM_kara	kAzva_kAzva_karanA/kukurU_kUM
rAjyABiReka_kara	rAjyABiReka
sammAniwa_kara	sammAniwa
samuxra_vihAra_kara	samuxra_vihAra
lakRya_prApwa_kara	lakRya_prApwa
carvaNa_kara	carvaNa
carvaNa_kara	carvaNa
saMgaNanA_kara	saMgaNanA
XarmayuxXa_kara	XarmayuxXa
Xarma_yuxXa_karane_vAlA	Xarma_yuxXa_karane_vAlA
BaviRyavANI_karane_kA_aByAsa	BaviRyavANI_karane_kA_aByAsa
kUka_karane_vAlI_GaMtAGadI	kUka_karane_vAlI_GaMtAGadI
KewI_kara	KewI
niyanwriwa_kara	niyanwriwa
niroga_kara	niroga
kama_kara	kama
UparI_DaMga_se_kara	UparI_DaMga_se
KilavAdZa_kara	KilavAdZa
nama_kara	nama
hawowsAha_kara	hawowsAha
nama_kara	nama_kara
nqwya_karanA/nAca	nqwya_karanA/nAcanA
sAhasa_kara	sAhasa
raPZU_kara	raPZU
niruwsAhiwa_kara	niruwsAhiwa_kara
cakAcOMXa_kara	cakAcOMXa_kara
vyavahAra_kara	vyavahAra
varNana_kara	varNana
sAmanA_kara	sAmanA
vyApAra_karanA/	vyApAra_karanA/
vyApArI/lena_xena_karanevAlA	vyApArI/lena_xena_karanevAlA
bahiRkqwa_kara	bahiRkqwa_kara
GatAnA/paxavI_se_uwAranA/KotA_karanA/mUlya_GatA	GatAnA/paxavI_se_uwAranA/KotA_karanA/mUlya_GatAnA
vAxa_vivAxa_karanA/bahasa_kara	vAxa_vivAxa_karanA/bahasa
xurbala_kara	xurbala
vikeMxriwa_kara	vikeMxriwa
niScaya_kara	niScaya
bahuwa_kama_kara_xe	bahuwa_kama_kara_xenA
GoRiwa_kara	GoRiwa
GoRiwa_kara	GoRiwa
uxGoRaNA_kara	uxGoRaNA
manA_kara	manA
upaniveRa_ko_CodZanA_yA_svawaMwra_GoRiwa_kara	upaniveRa_ko_CodZanA_yA_svawaMwra_GoRiwa
saMracanA_Bexa_kara	saMracanA_Bexa
visaMxURiwa_kara_xe	visaMxURiwa_kara_xenA
alaMkqwa_kara	alaMkqwa
paxaka_praxAna_kara	paxaka_praxAna
samarpiwa_kara	samarpiwa
wIvrawA_kama_kara	wIvrawA_kama
wIvrawA_meM_kamI_karanevAlA	wIvrawA_meM_kamI_karanevAlA
vikqwa_kara_xe	vikqwa_kara_xenA
baxanAma_kara	baxanAma
BugawAna_na_kara	BugawAna_na
viPala_kara_xe	viPala_kara_xenA
malawyAga_kara	malawyAga
eka_rAjanEwika_pArtI_ko_wyAga_kara_xUsarI_meM_SAmila_ho	eka_rAjanEwika_pArtI_ko_wyAga_kara_xUsarI_meM_SAmila
rakRA_kara	rakRA
rakRA_karane_vAlA	rakRA_karane_vAlA
AsWagiwa_kara	AsWagiwa
svIkAra_kara	svIkAra
Axara_kara	Axara
xURiwa_kara	xURiwa
apaviwra_kara	apaviwra
BARiwa_kara	BARiwa_kara
spaRta_kara	spaRta
sImAMkana_kara	sImAMkana
pakkA_kara	pakkA
AwmaviSvAsa_kama_kara	AwmaviSvAsa_kama
mazhagAI_kama_kara	mazhagAI_kama
cariwra_naRta_kara	cariwra_naRta
pawrarahiwa_kara	pawrarahiwa
kapata_karake_hara	kapata_karake_haranA
axA_kara	axA
wanAva_kama_kara	wanAva_kama
avajFA_kara	avajFA
paxAvanawa_kara	paxAvanawa
barPa_rahiwa_kara	barPa_rahiwa_kara
pUjA_kara	pUjA
kqpA_kara	kqpA
xqRtipAwa_kara	xqRtipAwa
xerI_kara	xerI_kara
prawiniXiwva_karane_ke_liye_Beja	prawiniXiwva_karane_ke_liye_BejanA
vicAra_kara	vicAra
jAnabUJa_kara	jAnabUJa_kara
soca_samaJa_kara	soca_samaJa_kara
sImA_nirXAriwa_kara	sImA_nirXAriwa
KUba_CAnabIna_kara	KUba_CAnabIna
cumbakawva_naRta_kara	cumbakawva_naRta
sImAMkana_kara	sImAMkana
POja_kI_nOkarI_se_mukwa_kara	POja_kI_nOkarI_se_mukwa
viXvaMsa_kara	viXvaMsa
muxrAkaraNa_kara	muxrAkaraNa
praxarSana_kara	praxarSana
pramANiwa_kara	pramANiwa
praxarSana_karawe_hue	praxarSana_karawe_hue
praxarSana_kara	praxarSana
niruwsAha_kara	niruwsAha
paxAvanawa_kara	paxAvanawa
EwarAja_karanA/Apawwi_kara	EwarAja_karanA/Apawwi
virARtrIkaraNa_kara	virARtrIkaraNa
baxanAma_kara	baxanAma
sUciwa_kara	sUciwa
ke_bAre_meM_sUciwa_kara	ke_bAre_meM_sUciwa
samApwa_kara	samApwa
nirAvqwa_karanA/uGAdZa	nirAvqwa_karanA/uGAdZanA
asvIkAra_karanA/bAwa_kAta	asvIkAra_karanA/bAwa_kAtanA
vaMciwa_kara	vaMciwa
nirBara_kara	nirBara_kara
KAlI_kara	KAlI
ninxA_kara	ninxA
nirvAsiwa_karanA2	nirvAsiwa_karanA2
nirvAsiwa_kara	nirvAsiwa
paxacyuwa_kara	paxacyuwa
jamA_kara	jamA
kI_ninxA_kara	kI_ninxA
mUlya_kA_nyUna_kara	mUlya_kA_nyUna
uxAsa_kara	uxAsa
kama_kara	kama
manxa_kara	manxa
vaMciwa_kara	vaMciwa
prawiniyukwa_kara	prawiniyukwa
prawiniyukwi_kara	prawiniyukwi
gadZabadZa_kara	gadZabadZa
upahAsa_kara	upahAsa
prApwa_kara	prApwa
aprawiRTA_kara	aprawiRTA
varNana_kara	varNana
BraRta_kara	BraRta
BraRta_kara	BraRta
varNaBexa_xUra_kara	varNaBexa_xUra
nirxiRta_kara	nirxiRta
niyukwa_kara	niyukwa
icCA_karanevAlA	icCA_karanevAlA
akelA_mahasUsa_kara	akelA_mahasUsa
GqNA_kara	GqNA
asWira_kara	asWira
asWira_kara	asWira
naRta_kara	naRta
wodZa_PodZa_kara	wodZa_PodZa
pqWaka_kara	pqWaka
vyOrevAra_varNana_kara	vyOrevAra_varNana
wEnAwa_kara	wEnAwa
nirXAraNa_karanA/niScaya_kara	nirXAraNa_karanA/niScaya
GqNA_kara	GqNA
XamAkA_karanA/ho	XamAkA_karanA/honA
AlocanA_karake_kalaMkiwa_karane_vAlA	AlocanA_karake_kalaMkiwa_karane_vAlA
mUlya_kama_kara	mUlya_kama
vikasiwa_kara	vikasiwa
samarpiwa_kara	samarpiwa
barbAxa_kara	barbAxa
lakRaNa_xeKakaranirNaya_kara	lakRaNa_xeKakaranirNaya
kArya_karane_meM_suswI	kArya_karane_meM_suswI
pawalA_kara	pawalA_kara
pAnI_se_pawalA_kara	pAnI_se_pawalA
Soragula_kara	Soragula
Bojana_kara	Bojana
balahIna_kara	balahIna
mAnane_se_inkAra_kara	mAnane_se_inkAra
nirASa_karanA/ho	nirASa_karanA/honA
asvIkAra_kara	asvIkAra
aswavyaswa_kara_xe	aswavyaswa_kara_xenA
asvIkAra_kara_xe	asvIkAra_kara_xenA
senABaMga_kara	senABaMga
bEristara_ko_paxacyuwa_kara	bEristara_ko_paxacyuwa
viSvAsa_na_kara	viSvAsa_na
niyama_pAlana_karanevAlA	niyama_pAlana_karanevAlA
anuSAsiwa_kara	anuSAsiwa
asvIkAra_kara	asvIkAra
pareSAna_kara	pareSAna_kara
kRubXa_kara_xe	kRubXa_kara_xenA
alaga_kara	alaga
hawowsAhiwa_kara	hawowsAhiwa
baxanAma_kara	baxanAma
Bexa_kara	Bexa
Bexa_kara	Bexa
carcA_kara	carcA
avahelanA_kara	avahelanA
SarIrahIna_kara	SarIrahIna_kara
alaga_kara	alaga
aruci_prakata_kara	aruci_prakata
virUpiwa_kara	virUpiwa
apamAna_kara	apamAna
GqNA_kara	GqNA
aswa_vyaswa_kara_xe	aswa_vyaswa_kara_xenA
apamAniwa_kara	apamAniwa
rogANuoM_se_mukwa_karanevAlA_xravya	rogANuoM_se_mukwa_karanevAlA_xravya
alaga_alaga_kara	alaga_alaga
jodZa_alaga_kara	jodZa_alaga
pasaMxa_na_kara	pasaMxa_na
viGatiwa_kara	viGatiwa
nirASa_kara	nirASa
aMga_BaMga_kara	aMga_BaMga
baraKAswa_kara	baraKAswa
ulatA_pulatA_kara	ulatA_pulatA
aMgIkAra_na_kara	aMgIkAra_na
burAI_kara	burAI
xUra_kara	xUra
praxarSana_kara	praxarSana
xiKAvA_kara	xiKAvA
nArAjZa_kara	nArAjZa
aprasanna_kara	aprasanna
upayoga_karake_PEMkane_lAyaka	upayoga_karake_PEMkane_lAyaka
kuCa_karane_kelie_wEyAra	kuCa_karane_kelie_wEyAra
svawva_haraNa_kara	svawva_haraNa
vivAxa_kara	vivAxa
wiwara-biwara_kara	wiwara-biwara
SoXa_kelie_lASa_yA_pOXoM_kI_cIraPAdZa_kara	SoXa_kelie_lASa_yA_pOXoM_kI_cIraPAdZa
xUra_kara	xUra
apavyaya_kara	apavyaya
alaga_karanA_yA_ho_jA	alaga_karanA_yA_ho_jAnA
svayaM_ko_kisI_se_xUra_kara	svayaM_ko_kisI_se_xUra
svacCa_kara	svacCa
alaga_kara	alaga_kara
Bexa_nikAlanA/pahacAnanA/alaga_kara	Bexa_nikAlanA/pahacAnanA/alaga
bAztanA/viwaraNa_karanA/viBAga_kara	bAztanA/viwaraNa_karanA/viBAga
aviSvAsa_karanA/saMxeha_kara	aviSvAsa_karanA/saMxeha
viGna_dAlanA/SAMwi_BaMga_kara	viGna_dAlanA/SAMwi_BaMga
Binna_Binna_karanA/raMga_biraMgA_kara	Binna_Binna_karanA/raMga_biraMgA
uwAranA/uGAdZanA/2.vaMciwa_karanA/CIna	uwAranA/uGAdZanA/2.vaMciwa_karanA/CInanA
BAga_kara	BAga
BaviRyavANI_kara	BaviRyavANI_kara
walAka_xenA/vivAha_vicCexa_kara	walAka_xenA/vivAha_vicCexa
pqWaka_kara	pqWaka
prakata_karanA/Kola_xe	prakata_karanA/Kola_xenA
GAta_meM_KadZA_karanA/jahAja_goxAma_meM_raKa	GAta_meM_KadZA_karanA/jahAja_goxAma_meM_raKanA
SAsana_kara	SAsana
awyAcAra_karanA/kaTorawA_se_SAsana_kara	awyAcAra_karanA/kaTorawA_se_SAsana
pahananA/grahaNa_kara	pahananA/grahaNa
xAna_kara	xAna
binxu_se_cihniwa_kara	binxu_se_cihniwa
behaxa_pyAra_kara	behaxa_pyAra
xo_nAmoM_para_ArakRiwa_kara	xo_nAmoM_para_ArakRiwa
acCI_waraha_se_cEka_kara	acCI_waraha_se_cEka
samAnAnwara_gAdZI_KadZI_kara	samAnAnwara_gAdZI_KadZI
xuganA_kara	xuganA_kara
saMxeha_kara	saMxeha
sanxeha_karane_vAlA_vyakwi	sanxeha_karane_vAlA_vyakwi
sahI_waraha_se_kara	sahI_waraha_se
swara_kama_kara	swara_kama
kampyUtara_me_detA_trAMsavara_kara	kampyUtara_me_detA_trAMsavara
Kanija_kI_Koja_kara	Kanija_kI_Koja
BarwI_kara	BarwI
KAlI_kara	KAlI_kara
nAtaka_ke_rUpa_meM_parivarwiwa_kara	nAtaka_ke_rUpa_meM_parivarwiwa
KIMca_kara_nikAla	KIMca_kara_nikAlanA
AkarRiwa_kara	AkarRiwa
ekawriwa_kara	ekawriwa
nambara_yA_kArda_yA_tikata_uTA_kara_vijayI_GoRiwa_kara	nambara_yA_kArda_yA_tikata_uTA_kara_vijayI_GoRiwa
BIdZa_ko_ekawriwa_karane_hewu_kArya_yA_Gata	BIdZa_ko_ekawriwa_karane_hewu_kArya_yA_GatanA
KAkA_wEyAra_kara	KAkA_wEyAra
WElA_Axi_bazxa_karane_kI_dorI	WElA_Axi_bazxa_karane_kI_dorI
KIMca_kara_pula_ko_bazxa_karane_vAlA_waKwA	KIMca_kara_pula_ko_bazxa_karane_vAlA_waKwA
hErAna_karane_lAyaka	hErAna_karane_lAyaka
naxI_ke_wala_se_mitatI_KIMcanA-KIMca_kara_nikAla	naxI_ke_wala_se_mitatI_KIMcanA-KIMca_kara_nikAlanA
BigonA/gIlA_kara	BigonA/gIlA
pattI_kara	pattI
sAPa_kara	sAPa
baDZA_caDZA_kara_kaha	baDZA_caDZA_kara_kahanA
mekaapa_karane_vAlA	mekaapa_karane_vAlA
pravAhiwa_kara	pravAhiwa
Cexa_karane_vAlI_maSIna	Cexa_karane_vAlI_maSIna
kaTora_anuSAsana_meM_raha_kara_SikRA_xe	kaTora_anuSAsana_meM_raha_kara_SikRA_xenA
kisI_kAma_ko_karane_kA_sahI_warIkA	kisI_kAma_ko_karane_kA_sahI_warIkA
Cexa_kara	Cexa
anuSAsana_meM_raha_kara_SikRA_xe	anuSAsana_meM_raha_kara_SikRA_xenA
pInA/pAna_kara	pInA/pAna
maxirA_pAna_kara	maxirA_pAna
bAXya_kara	bAXya
geMxa_jora_se_hita_kara	geMxa_jora_se_hita
preriwa_kara	preriwa
UrjasviwA_karmaSakwi	UrjasviwA_karmaSakwi
AvAjZa_kara	AvAjZa
arUcipUrNakAma_karanevAlA	arUcipUrNakAma_karanevAlA
xvaMxa_yuxXa_kara	xvaMxa_yuxXa
suswa_kara	suswa
wakAjZA_karane_vAlA/wakAjZA	wakAjZA_karane_vAlA/wakAjZA
wakAjZA_kara	wakAjZA
para_vicAra_kara	para_vicAra
nivAsa_kara	nivAsa
iyara_plaga	iyara_plaga
wanAva_kama_kara	wanAva_kama
prawiXvani_kara	prawiXvani
kamaKarce_meM_kara	kamaKarce_meM
kinArA_Age_yA_Upara_kI_ora_karake	kinArA_Age_yA_Upara_kI_ora_karake
saMpAxana_kara	saMpAxana
SikRA_praxAna_kara	SikRA_praxAna
pUrA_kara	pUrA
viswAra_kara	viswAra
praPulliwa_kara	praPulliwa_kara
nirvAcana_kara	nirvAcana
cunAva_ke_lie_nirvAcana_kara	cunAva_ke_lie_nirvAcana
vixyuwIkaraNa_kara	vixyuwIkaraNa
bijalI_ke_karaMta_se_mara	bijalI_ke_karaMta_se_maranA
laMbA_karanA/wAnanA/badZA	laMbA_karanA/wAnanA/badZAnA
gabana_kara	gabana
kadZuvAhata_pExA_kara	kadZuvAhata_pExA
alaMkaraNa_kara	alaMkaraNa
sAkAra_kara	sAkAra
nakkASI_kara	nakkASI
AliMgana_kara	AliMgana
aMgIkAra_kara	aMgIkAra
saMSoXiwa_kara	saMSoXiwa
uwpravAsa_karanA/vixeSa_meM_rahane_cale_jA	uwpravAsa_karanA/vixeSa_meM_rahane_cale_jAnA
uwsarjana_kara	uwsarjana_kara
samarWa_kara	samarWa_kara
KAlI_kara	KAlI
mInAkArI_kara	mInAkArI
mohiwa_kara	mohiwa
uwsAhiwa_kara	uwsAhiwa
yawna_kara	yawna
samarWana_kara	samarWana
WakA	WakAnA
lAgU_kara	lAgU
sagAI_kara	sagAI
nimagna_kara	nimagna_kara
prabuxXa_kara	prabuxXa
BarwI_karanA_/sUci_pawra_meM_nAma_liKa	BarwI_karanA_/sUci_pawra_meM_nAma_liKanA
uwwejiwa_kara	uwwejiwa
gussA_xilAnA/kupiwa_kara	gussA_xilAnA/kupiwa
pICA_kara	pICA
apekRA_kara	apekRA
praveSa_kara	praveSa_kara
sawkAra_kara	sawkAra
anunaya_vinaya_kara	anunaya_vinaya_kara
cAroM_ora_KAI_Koxa_kara_surakRiwa_kara	cAroM_ora_KAI_Koxa_kara_surakRiwa
uccAraNa_kara	uccAraNa
vyakwa_kara	vyakwa
Avqwa_kara	Avqwa
saMBAvanA_kA_XyAna_kara	saMBAvanA_kA_XyAna
IrRyA_kara	IrRyA
samAna_karanA/barAbara_kara	samAna_karanA/barAbara
sajjiwa_kara	sajjiwa
xvayArWaka_bAwa_kara	xvayArWaka_bAwa
banAnA/KadA_kara	banAnA/KadA
galawI_kara	galawI
baca_kara_BAga_jA	baca_kara_BAga_jAnA
pahare_ke_sAWa_jAnA/paharA_karanA/rakRA_kara	pahare_ke_sAWa_jAnA/paharA_karanA/rakRA
sagAI_kara	sagAI
vivAha_kara	vivAha
grahaNa_kara	grahaNa
prayawna_karanA/pariSrama_karanA/jAzca	prayawna_karanA/pariSrama_karanA/jAzcanA
sWApiwa_kara	sWApiwa
pramANiwa_kara	pramANiwa
sammAna_kara	sammAna
alaga_kara_xenA/xUra_raKa	alaga_kara_xenA/xUra_raKanA
uwkIrNa_kara	uwkIrNa
nakkASI_kara	nakkASI
swuwi_karanA/kaha_kara_yA_liKa_kara_kisI_kI_praSaMsA_kara	swuwi_karanA/kaha_kara_yA_liKa_kara_kisI_kI_praSaMsA
KAlI_kara	KAlI
tAla_matola_karanA/tAla	tAla_matola_karanA/tAlanA
mUlyAMkana_kara	mUlyAMkana
IsAI_Xarma_meM_parivarwana_kara	IsAI_Xarma_meM_parivarwana
barAbara_kara	barAbara
barAbara_kara	barAbara_kara
bexaKala_karana	bexaKala_karana
AhvAna_kara	AhvAna
vikAsa_kara	vikAsa_kara
parIkRaNa_kara	parIkRaNa
ko_CodZa_kara	ko_CodZa_kara
axalA_baxalA_kara	axalA_baxalA
uwwejiwa_kara	uwwejiwa
samAja_se_bAhara_kara	samAja_se_bAhara
kRamA_kara	kRamA
kAryAnviwa_kara	kAryAnviwa
kAryAnviwa_karane_vAlA	kAryAnviwa_karane_vAlA
mukwa_kara	mukwa
vyAyAma_kara	vyAyAma
praxarSana_kara	praxarSana
harRiwa_karanA/ho	harRiwa_karanA/honA
pqWvI_Koxa_kara_nikAla	pqWvI_Koxa_kara_nikAlanA
SIGrawA_kara	SIGrawA
vyaya_kara	vyaya
anuBava_kara	anuBava
parIkRA_kara	parIkRA
SoRaNa_kara	SoRaNa
upayoga_kara	upayoga
SoRaNa_kara	SoRaNa
niryAwa_kara	niryAwa
vyAKyA_kara	vyAKyA
vyakwa_kara	vyakwa
pUrNawayA_naRta_kara	pUrNawayA_naRta
hapwA_lenevAlA/balAw_XanApaharaNa_karwA	hapwA_lenevAlA/balAw_XanApaharaNa_karwA
sugama_karanA/maxaxa_xenA/sarala_banA	sugama_karanA/maxaxa_xenA/sarala_banAnA
SurU_kara	SurU
paMKA_kara	paMKA
BadZakAnA/uwwejiwa_kara	BadZakAnA/uwwejiwa
pasanxa_kara	pasanxa
Age_jAnA/pragawi_kara	Age_jAnA/pragawi
KewI_kara	KewI
viSeRa_prakAra_kI_Akqwi_praxAna_kara	viSeRa_prakAra_kI_Akqwi_praxAna
motA_kara	motA
anugraha_prApwa_kara	anugraha_prApwa
prema_jawalAnA/cApalUsI_kara	prema_jawalAnA/cApalUsI
PEksa_kara	PEksa
kRubXa_kara	kRubXa_kara
Baya_kara	Baya
awyaMwa_BayaBIwa_kara	awyaMwa_BayaBIwa
Bojana_kara	Bojana
Annaxiwa_karana	Annaxiwa_karana
kaTina_kArya_ko_kara	kaTina_kArya_ko
uwwejiwa_kara	uwwejiwa
kisI_ko_BayaBIwa_kara	kisI_ko_BayaBIwa
prakata_kara	prakata
saMGa_kA_anumoxana_kara	saMGa_kA_anumoxana
saMGavAxI	saMGavAxI
viSvAsaGAwa_kara	viSvAsaGAwa
Bojana_karAne_vAlA	Bojana_karAne_vAlA
mahasUsa_kara	mahasUsa
sparSa_se_anuBava_kara	sparSa_se_anuBava
mahasUsa_karane_vAlA	mahasUsa_karane_vAlA
svAzga_kara	svAzga
aBinanxana_kara	aBinanxana
muzha_se_liMga_ko_uwwejiwa_kara	muzha_se_liMga_ko_uwwejiwa
apane_mawaBexoM_ko_xUra_kara	apane_mawaBexoM_ko_xUra
GumA_PirA_ke_bAwa_kara	GumA_PirA_ke_bAwa
walavAra_se_ladZAI_kara	walavAra_se_ladZAI
xeKaBAla_kara	xeKaBAla
uwwejiwa_kara	uwwejiwa
kAma_karavA	kAma_karavAnA
sawkAra_kara	sawkAra
jAxU_tone_meM_viSvAsa_karane_vAlA	jAxU_tone_meM_viSvAsa_karane_vAlA
beImAnI_kara	beImAnI
vyarWa_kI_bAwa_kara	vyarWa_kI_bAwa
nirarWaka_kAma_kara	nirarWaka_kAma
PIlda_testa_kara	PIlda_testa
kRewra_rakRaNa_kara	kRewra_rakRaNa
nIcawA_kI_haxa_kara	nIcawA_kI_haxa
paravAha_na_kara	paravAha_na
paravAha_na_kara	paravAha_na
ladAI_kara	ladAI
wIvrawA_se_ladAI_kara	wIvrawA_se_ladAI
JagadZA_kara	JagadZA
kalpanA_kara	kalpanA
anumAna_kara	anumAna
corI_kara	corI
PAila	PAila
sUcanA_xarja_kara	sUcanA_xarja
kArya_meM_vilamba_karavA	kArya_meM_vilamba_karavAnA
kArya_meM_vilamba_karavAne_saMbaMXI	kArya_meM_vilamba_karavAne_saMbaMXI
xUsare_ke_sWAna_para_kAma_kara_sakane_kI_yogyawA	xUsare_ke_sWAna_para_kAma_kara_sakane_kI_yogyawA
pUrA_kara	pUrA
pEsoM_kA_lena_xena_karane_vAlI_kaMpanI	pEsoM_kA_lena_xena_karane_vAlI_kaMpanI
pEsoM_kA_lena_xena_karane_vAlI_saMsWA	pEsoM_kA_lena_xena_karane_vAlI_saMsWA
anuBava_kara	anuBava
saba_milA_kara	saba_milA_kara
svIkAra_kara	svIkAra
PEsalA_kara	PEsalA
PEsalA_kara	PEsalA
pawA_kara	pawA
kisI_kAma_ko_acCI_waraha_kara	kisI_kAma_ko_acCI_waraha
bArIkI_se_jAzca_padZawAla_kara	bArIkI_se_jAzca_padZawAla
bArIkI_se_jAzca_padZawAla_kara	bArIkI_se_jAzca_padZawAla
pUrNa_kara	pUrNa
samApwa_kara	samApwa
prahAra_kara	prahAra
xqDZa_kara	xqDZa
dAka_tikata_jArI_karane_ke_xina_kI_muhara_kA_liPAPA	dAka_tikata_jArI_karane_ke_xina_kI_muhara_kA_liPAPA
pahalI_bAra_aparAXa_karanevAlA	pahalI_bAra_aparAXa_karanevAlA
niSciwa_kara	niSciwa
wEyAra_kara	wEyAra
TIka_kara	TIka
sAzTa_gAzTa_kara	sAzTa_gAzTa
puRta_kara	puRta
acaMBiwa_kara	acaMBiwa
parawa_kara	parawa
svayaM_kI_ora_AkarRiwa_kara	svayaM_kI_ora_AkarRiwa
DIla_DAla_kara	DIla_DAla
cinwA_kara	cinwA
cApalUsI_kara	cApalUsI
cApalUsI_karane_vAlA	cApalUsI_karane_vAlA
praSaMsA_karane_yogya	praSaMsA_karane_yogya
baDZA_caDZAkara_bAwa_kara	baDZA_caDZAkara_bAwa
AlocanA_kara	AlocanA
gussA_prakata_kara	gussA_prakata
GqNA_kara	GqNA
GqNA_kara	GqNA
bakavAsa_karane_vAlA	bakavAsa_karane_vAlA
Jatake_se_gAyaba_kara	Jatake_se_gAyaba
Jatake_se_gAyaba_kara	Jatake_se_gAyaba
Jatake_se_gAyaba_kara	Jatake_se_gAyaba
kisI_ko_BAgane_ko_majabUra_kara	kisI_ko_BAgane_ko_majabUra
wAlASa_kara	wAlASa
iSkabAjZI_kara	iSkabAjZI
vicAra_kara	vicAra
CedZaCAdZa_karanevAlA	CedZaCAdZa_karanevAlA
jZArI_kara	jZArI
vyarWa_kA_prayawna_kara	vyarWa_kA_prayawna
bora_kara	bora
svayaM_para_awyAcAra_kara	svayaM_para_awyAcAra
svayaM_para_awyAcAra_kara	svayaM_para_awyAcAra
Bara_kara_baha	Bara_kara_bahanA
wejZa_roSanI_se_prakASiwa_kara	wejZa_roSanI_se_prakASiwa
nicale_swara_se_kAma_SurU_kara	nicale_swara_se_kAma_SurU
nicale_swara_se_kAma_SurU_kara	nicale_swara_se_kAma_SurU
kArya_AramBa_kara	kArya_AramBa
Waka_kara_bETa_jA	Waka_kara_bETa_jAnA
xAzwa_sAPa_karane_kA_XAgA	xAzwa_sAPa_karane_kA_XAgA
KarAba_DaMga_se_kara	KarAba_DaMga_se
acAnaka_kroXa_kara	acAnaka_kroXa
acAnaka_kroXa_kara	acAnaka_kroXa
acAnaka_kroXa_kara	acAnaka_kroXa
kroXa_kara	kroXa
AkramaNa_kara	AkramaNa
xOdZa_kara_lI_kuxAna	xOdZa_kara_lI_kuxAna
strAika_karane_ko_wEyAra_kAmagara	strAika_karane_ko_wEyAra_kAmagara
manA_kara	manA
kenxriwa_kara	kenxriwa
kohare_meM_iswemAla_karane_ke_liye_wejZa_roSanI	kohare_meM_iswemAla_karane_ke_liye_wejZa_roSanI
kohare_meM_iswemAla_karane_ke_liye_wejZa_roSanI	kohare_meM_iswemAla_karane_ke_liye_wejZa_roSanI
waha_kara	waha
baMxa_kara	baMxa
apane_pAsa_kara	apane_pAsa
loka_kaWAoM_kA_aXXayana_karane_vAlA	loka_kaWAoM_kA_aXXayana_karane_vAlA
anusaraNa_karanA/anukaraNa_kara	anusaraNa_karanA/anukaraNa
pICA_kara	pICA
anugamana_kara	anugamana
varNana_kara	varNana
vahI_kara	vahI
barwana	barwana
kisI_ke_pEra_ko_apane_pEroM_se_sparSa_kara	kisI_ke_pEra_ko_apane_pEroM_se_sparSa
manA_kara	manA
majabUra_kara	majabUra
jabaraxaswI_uwpanna_kara	jabaraxaswI_uwpanna
na_karane_kA_bahA	na_karane_kA_bahAnA
pAra_kara	pAra
wEyArI_kara	wEyArI
pUrvAnumAna_karane_vAlA	pUrvAnumAna_karane_vAlA
kabjA_kara_le	kabjA_kara_lenA
pahale_se_nivAraNa_kara	pahale_se_nivAraNa
KabaraxAra_kara	KabaraxAra
jAlasAjZI_kara	jAlasAjZI
kRamA_kara	kRamA
SapaWa_KA_kara_CodZa	SapaWa_KA_kara_CodZanA
kilebanxI_kara	kilebanxI
xURiwa_kara	xURiwa
sWApanA_kara	sWApanA
jo_PrAMsa_saByawA_pasaMxa_karawA_ho	jo_PrAMsa_saByawA_pasaMxa_karawA_ho
BrAwq_BAva_uwpanna_karane_vAlA	BrAwq_BAva_uwpanna_karane_vAlA
svajanoM_se_kalaha_karanevAlA	svajanoM_se_kalaha_karanevAlA
Cala_kA_prayAsa_karane_vAlA	Cala_kA_prayAsa_karane_vAlA
mukwa_kara	mukwa
svawaMwra_kArya_karane_vAlA	svawaMwra_kArya_karane_vAlA
mukwa_kara	mukwa
muPwa_Pona	muPwa_Pona
PrI_posta	PrI_posta
maxirA_ko_pawalA_kara	maxirA_ko_pawalA
cinwA_prakata_kara	cinwA_prakata
sahAyawA_karane_vAlA_saMGa	sahAyawA_karane_vAlA_saMGa
pareSAna_karane_vAlA	pareSAna_karane_vAlA
walASI_kara	walASI
gaMBIrawA_se_vicAra_na_karane_vAlA	gaMBIrawA_se_vicAra_na_karane_vAlA
hAWa_pICa_karake_jZabarxaswI_calavA	hAWa_pICa_karake_jZabarxaswI_calavAnA
Amoxa_pramoxa_kara	Amoxa_pramoxa
sAmanA_kara	sAmanA
nirASa_kara	nirASa
mEWuna_kara	mEWuna
asaMgawa_bAwa_kara	asaMgawa_bAwa
pUrA_kara	pUrA
apekRAez_pUrI_kara	apekRAez_pUrI
eka_prakAra_kI_mittI	eka_prakAra_kI_mittI
kroXa_kara	kroXa
kisI_mawa_kA_xqDa_pAlana_kara	kisI_mawa_kA_xqDa_pAlana
kriyA_karma_sambanXI	kriyA_karma_sambanXI
kriyA_karma	kriyA_karma
Gisa_kara_camakA	Gisa_kara_camakA
susajjiwa_kara	susajjiwa
muzha_banxa_kara	muzha_banxa
InkAra_kara	InkAra
kisI_ko_lajjiwa_kara	kisI_ko_lajjiwa
janamawa_nirXAriwa_karane_kA_mawaxAna	janamawa_nirXAriwa_karane_kA_mawaxAna
uwwejiwa_kara	uwwejiwa
Kela_ArakRiwa_kRewra_kI_xeKaBAla_karane_vAlA	Kela_ArakRiwa_kRewra_kI_xeKaBAla_karane_vAlA
kullA_kara	kullA
kullA_karane_kA_warala_paxArWa	kullA_karane_kA_warala_paxArWa
ekawra_kara	ekawra
alaMkqwa_kara	alaMkqwa
moracA_banxI_kara	moracA_banxI
gEsa_meM_parivarwiwa_kara	gEsa_meM_parivarwiwa
gaharA_GAva_kara	gaharA_GAva
baMxa_kara	baMxa
ikaTTA_kara	ikaTTA_kara
ikaTTA_kara	ikaTTA
wEyArI_kara	wEyArI
golamAla_kara	golamAla
iSArA_kara	iSArA
rAjI_kara	rAjI
prasWAna_kara	prasWAna
puna:_prApwa_kara	puna:_prApwa
javAba_xenA/puna:_samparka_kara	javAba_xenA/puna:_samparka
nirASiwa_kara	nirASiwa
kuCa_kara_pA	kuCa_kara_pAnA
pragawi_kara	pragawi
samApwa_kara	samApwa
pUrA_kara	pUrA
pAra_kara	pAra
ekawra_kara	ekawra
prabanXa_kara	prabanXa
praveSa_karanA_[->meM]	praveSa_karanA_[->meM]
koI_aparAXa_karake_BAga_jA	koI_aparAXa_karake_BAga_jAnA
pAnI_garma_karane_kA_sAXana	pAnI_garma_karane_kA_sAXana
hIM-hIM-TI-TI_kara	hIM-hIM-TI-TI
hI-hIM-TI-TI_kara	hI-hIM-TI-TI
kalaI_kara	kalaI
kisI_ko_prowsAhiwa_kara	kisI_ko_prowsAhiwa
kanyAxAna_kara	kanyAxAna
prasanna_kara	prasanna
sUcanA_prApwa_kara	sUcanA_prApwa
cikanI_cupadZI_bAweM_karane_vAlA	cikanI_cupadZI_bAweM_karane_vAlA
visarpaNa_kara	visarpaNa
XuMXalA_kara	XuMXalA
baDZAI_kara	baDZAI
jarurawa_se_jyAxA_pUrwi_kara	jarurawa_se_jyAxA_pUrwi
pICA_kara	pICA
vyavasAya_kara	vyavasAya
aXyayana_kara	aXyayana
jo_preriwa_karawI_hE	jo_preriwa_karawI_hE
preriwa_kara	preriwa
jalxI_Ora_AvAjZa_karake_KA	jalxI_Ora_AvAjZa_karake_KAnA
pIrU_kI_waraha_AvAjZa_karanA'	pIrU_kI_waraha_AvAjZa_karanA'
CotA_motA_praSAsanika_kAma_karane_vAlA	CotA_motA_praSAsanika_kAma_karane_vAlA
xeKa	xeKanA
cugalI_kara	cugalI
Cexa_karake_nikAla	Cexa_karake_nikAlanA
Cexa_karanA_kA_yaMwra	Cexa_karanA_kA_yaMwra
rAjya_kara	rAjya
suSoBiwa_kara	suSoBiwa
upAXi_prApwa_kara	upAXi_prApwa
kalama_kara	kalama
sanwuRta_kara	sanwuRta
cikanA_kara	cikanA
praNAma_kara	praNAma
raMja_kara	raMja
mElA_kara	mElA
uwsAhiwa_karane_vAlA	uwsAhiwa_karane_vAlA
SikAyawa_kara	SikAyawa
GodZe_kI_xeKareKa_kara	GodZe_kI_xeKareKa
CotI-CotI_bAwoM_kI_SikAyawa_kara	CotI-CotI_bAwoM_kI_SikAyawa
raKavAlI_kara	raKavAlI
aguvAI_kara	aguvAI
paraspara_sahAyawA_va_rakRA_karane_vAlI_maNdalI	paraspara_sahAyawA_va_rakRA_karane_vAlI_maNdalI
galala_galala_kara	galala_galala
hEkara	hEkara
mola_BAva_kara	mola_BAva
roMgate_KadZe_kara_xene_vAlA	roMgate_KadZe_kara_xene_vAlA
keSa_karwana	keSa_karwana
baMxa_kara_xe	baMxa_kara_xenA
rukaruka_kara	rukaruka_kara
AXA_kara_xe	AXA_kara_xenA
asvABAvika_aBinaya_kara	asvABAvika_aBinaya
rukAvata_pExA_kara	rukAvata_pExA
prabanXa_kara	prabanXa
xeKaBAla_karane_vAlA_vyakwi	xeKaBAla_karane_vAlA_vyakwi
mila-jula_kara_raha	mila-jula_kara_rahanA
AzweM_nikAla_kara_Awma_hawyA_kara	AzweM_nikAla_kara_Awma_hawyA
pareSAna_kara	pareSAna
kaTora_pariSrama_karanevAlA	kaTora_pariSrama_karanevAlA
kadZA_kara	kadZA
pareSAna_kara	pareSAna
katAI_karanevAlA_yaMwra	katAI_karanevAlA_yaMwra
pareSAna_kara	pareSAna
jalxI_kara	jalxI
GqNA_kara	GqNA
pareSAna_kara	pareSAna
BarwI_karAne_vAlA_kAryakarwA	BarwI_karAne_vAlA_kAryakarwA
garama_kara	garama
garama_karane_kI_paxXawi	garama_karane_kI_paxXawi
binA_kAma_karane_vAlI_pecIxA_maSIna	binA_kAma_karane_vAlI_pecIxA_maSIna
sahAyawA_kara	sahAyawA
svawa:_SoXa_karake_sIKane_se_saMbaMXiwa	svawa:_SoXa_karake_sIKane_se_saMbaMXiwa
avikqwa_Xvani_uwpanna_karane_vAlA	avikqwa_Xvani_uwpanna_karane_vAlA
SabxoM_para_jora_va_aMkiwa_karane_kA_kalama	SabxoM_para_jora_va_aMkiwa_karane_kA_kalama
apaharaNa_kara	apaharaNa
pAxa_yAwrA_kara	pAxa_yAwrA
3_prasannawA_pragata_karane_vAle_Sabxa	3_prasannawA_pragata_karane_vAle_Sabxa
kirAye_kA_tattU	kirAye_kA_tattU
prahAra_kara	prahAra
kaBI_kAma_karanA_kaBI_nA_kara	kaBI_kAma_karanA_kaBI_nA
vAhana_xvArA_Ahawa_kara_BAga_jA	vAhana_xvArA_Ahawa_kara_BAga_jAnA
pEse_lekara_hawyA_karane_vAlA.peSevara_hawyArA	pEse_lekara_hawyA_karane_vAlA.peSevara_hawyArA
xUsare_ke_vAhana_para_muPwa_sEra_kara	xUsare_ke_vAhana_para_muPwa_sEra
laMgadZA_kara_cala	laMgadZA_kara_calanA
eka_sWAna_se_xUsare_sWAna_para_majaxUrI_karane_vAlA_majaxUra	eka_sWAna_se_xUsare_sWAna_para_majaxUrI_karane_vAlA_majaxUra
Gara_ke_kAma_meM_maxaxa_karane_vAlA	Gara_ke_kAma_meM_maxaxa_karane_vAlA
ekarUpa_kara	ekarUpa
pEnA_kara	pEnA
JagadZoM_meM_maXyasWawA_karane_vAlA	JagadZoM_meM_maXyasWawA_karane_vAlA
haMsa_ke_kAzva_kAzva_karane_kI_AvAja	haMsa_ke_kAzva_kAzva_karane_kI_AvAja
sammAna_kara	sammAna
cAlAkI_kara	cAlAkI
vekyUma_klIna_kara	vekyUma_klIna
ASA_kara	ASA
anAja_yA_koyalA_KAlI_karane_kA_sWAna	anAja_yA_koyalA_KAlI_karane_kA_sWAna
AwaMkiwa_kara	AwaMkiwa
GudZa_savArI_karane_vAlI_Orawa	GudZa_savArI_karane_vAlI_Orawa
sawkAra_karane_vAlA	sawkAra_karane_vAlA
aspawAla_meM_BarwI_kara	aspawAla_meM_BarwI
rajonivqwwi_meM_mahilAoM_ko_uRNawA_mahasUsa_kara	rajonivqwwi_meM_mahilAoM_ko_uRNawA_mahasUsa
Gara_kA_saMcAlana_karane_vAlA_vyakwi	Gara_kA_saMcAlana_karane_vAlA_vyakwi
makAna_kI_raKavAlI_karane_vAlA	makAna_kI_raKavAlI_karane_vAlA
Garelu_kAma_karane_vAlI_nOkarAnI	Garelu_kAma_karane_vAlI_nOkarAnI
mAnavIkaraNa_kara	mAnavIkaraNa
kUbadZa_uTAnA/prayAsa_kara	kUbadZa_uTAnA/prayAsa
BUKe_pyAse_mArca_kara	BUKe_pyAse_mArca
BUKa_hadZawAla_karane_vAlA	BUKa_hadZawAla_karane_vAlA
SikAra_kara	SikAra_kara
bAXA_uCala_kara_pAra_kara	bAXA_uCala_kara_pAra
bAXA_pAra_karawe_hue	bAXA_pAra_karawe_hue
jora_se_PeMka_kara_mAra	jora_se_PeMka_kara_mAranA
jalxI_kara	jalxI
KadZa_KadZa_karawe_hue_Age_baDZa	KadZa_KadZa_karawe_hue_Age_baDZanA
miwavyayawA_ke_sAWa_prabaMXa_kara	miwavyayawA_ke_sAWa_prabaMXa
awiSaya_praSaMsA_kara	awiSaya_praSaMsA_kara
kalpanA_kara	kalpanA
pUjA_kara	pUjA
avajFA_kara	avajFA
xurvyavahAra_kara	xurvyavahAra
prakASayukwa_kara	prakASayukwa
vyAKyA_kara	vyAKyA
vicAra_kara	vicAra
AwmasAwa_kara	AwmasAwa
nakZala_kara	nakZala
acala_kara	acala
jala_kara_mara	jala_kara_maranA
unmukwa_kara	unmukwa
baMxa_kara	baMxa
praxAna_kara	praxAna
preriwa_kara	preriwa
pararUpa_XAraNa_kara	pararUpa_XAraNa
aBinaya_kara	aBinaya
vakAlawa_kara	vakAlawa
prArWanA_kara	prArWanA
AyAwa_kara	AyAwa
haTa_kara	haTa
lAgU_kara	lAgU
jZabwa_kara	jZabwa
aSakwa_kara_xe	aSakwa_kara_xenA
se_vyApwa_kara	se_vyApwa
garBAxAna_kara	garBAxAna
praBAviwa_kara	praBAviwa
kZExa_kara	kZExa
wawkAla_wEyAra_kara	wawkAla_wEyAra
para_saMxeha_kara	para_saMxeha
uxGAtana_kara	uxGAtana
kZExa_kara	kZExa
Aga_babUlA_kara	Aga_babUlA
nArAjZa_karanA/gussA_xilA	nArAjZa_karanA/gussA_xilAnA
Basma_kara_xe	Basma_kara_xenA
uwkIrNa_kara	uwkIrNa
uwwejiwa_kara	uwwejiwa
sammiliwa_kara	sammiliwa
sammiliwa_karawe_hue	sammiliwa_karawe_hue
sammiliwa_kara	sammiliwa
vqxXi_kara	vqxXi_kara
kRawipUrwi_kara	kRawipUrwi
sUciwa_kara	sUciwa
eka_eka_karake/vyakwigawa_rUpa_se	eka_eka_karake/vyakwigawa_rUpa_se
viSiRta_kara_xe	viSiRta_kara_xenA
rAjZI_kara	rAjZI
niyukwa_kara	niyukwa
prasanna_kara	prasanna
sanwuRta_kara	sanwuRta
OxyogIkaraNa_kara	OxyogIkaraNa
anumAna_kara	anumAna
prajvaliwa_kara	prajvaliwa
avamUlyana_kara	avamUlyana
praBAviwa_kara	praBAviwa
sUcanA_xenA/sUciwa_kara	sUcanA_xenA/sUciwa
ullaMGana_kara	ullaMGana
kroXonmawwa_kara	kroXonmawwa
kroXiwa_karane_vAlA	kroXiwa_karane_vAlA
anugraha_prApwa_kara	anugraha_prApwa
meM_nivAsa_kara	meM_nivAsa
uwwarAXikAra_meM_prApwa_kara	uwwarAXikAra_meM_prApwa
niroXa_kara	niroXa
AramBa_kara	AramBa
AramBa_kara	AramBa
GAyala_kara	GAyala
jadAI_kara	jadAI
hAni_na_karane_vAlA	hAni_na_karane_vAlA
kampyUtara_meMsaMgaNana_kara	kampyUtara_meMsaMgaNana
pUCa-wACa_kara	pUCa-wACa
pUCa-wACa_karane_vAlA	pUCa-wACa_karane_vAlA
viXarmiyoz_ko_xamana_karane_kA_saMGa	viXarmiyoz_ko_xamana_karane_kA_saMGa
garBAXAna_kara	garBAXAna
cAlAkI_BarA_saMkewa_kara	cAlAkI_BarA_saMkewa
jZora_xe		 #Agraha_karanA jZora_xenA   #Agraha
sWApiwa_kara	sWApiwa
saMsWApiwa_kara	saMsWApiwa
alaga_kara	alaga
apamAna_kara	apamAna
bImA_kara	bImA_kara
ekIkaraNa_kara	ekIkaraNa
buxXisaMgawa_kara	buxXisaMgawa
wIvra_kara	wIvra
saSakwa_kara	saSakwa
jAna_bUJa_kara	jAna_bUJa_kara
eka_xUsare_ko_praBAviwa_kara	eka_xUsare_ko_praBAviwa
miSriwa_jAwijIva_uwpanna_kara	miSriwa_jAwijIva_uwpanna
maXyasWawA_kara	maXyasWawA
axalA_baxalA_kara	axalA_baxalA
anwarsaMbaxXa_kara	anwarsaMbaxXa
ruci_uwpanna_kara	ruci_uwpanna
milana-biMxu_kara	milana-biMxu
intIriyara_dekoretara	intIriyara_dekoretara
AMwara_dijZAina_karanevAlA	AMwara_dijZAina_karanevAlA
varNana_kara	varNana
BARAnwara_kara	BARAnwara
paraspara_saMbaxXa_kara	paraspara_saMbaxXa
praSna_kara	praSna
BaMga_kara	BaMga
guNiwa_karane_para	guNiwa_karane_para
anuwAna_kara	anuwAna
unmawwa_kara	unmawwa
paricaya_karA	paricaya_karA
praswuwa_kara	praswuwa
upalabXa_karA	upalabXa_karAnA
GusapETa_karane_vAlA	GusapETa_karane_vAlA
plAviwa_kara	plAviwa
AkramaNa_kara	AkramaNa
aviXimAnya_kara	aviXimAnya
nOkarI_CodZane_para_majabUra_kara	nOkarI_CodZane_para_majabUra
AviRkAra_kara	AviRkAra
ulatA_kara	ulatA
anusaMXAna_kara	anusaMXAna
jAzca_karane_vAlA	jAzca_karane_vAlA
jAzca_karwA	jAzca_karwA
nigarAnI_kara	nigarAnI
balavarXana_kara	balavarXana
AkqRta_kara	AkqRta
banAvatI_garBAXAna_kara	banAvatI_garBAXAna
ahvAna_kara	ahvAna
yAcanA_kara	yAcanA
SAmila_kara	SAmila
AyanoM_meM_parivarwiwa_kara	AyanoM_meM_parivarwiwa
pareSAna_karane_vAlA	pareSAna_karane_vAlA
iswrI_kara	iswrI
eksare_kiraNoM_se_upacAra_kara	eksare_kiraNoM_se_upacAra
jalana_pExA_karanevAlA	jalana_pExA_karanevAlA
kRubXa_kara	kRubXa
kRubXa_kara	kRubXa
pqWaka_kara	pqWaka
AxeSa_jArI_kara	AxeSa_jArI
prakASiwa_kara	prakASiwa
avaroXa_kara	avaroXa
rogZana_karake_camakA	rogZana_karake_camakAnA
sEra_kara	sEra
rAswA_pAra_karane_meM_lAparavAha_ho	rAswA_pAra_karane_meM_lAparavAha
saswe_paxArWoM_kA_upayoga_karane_vAlA	saswe_paxArWoM_kA_upayoga_karane_vAlA
kisI_kArya_ko_jArI_raKane_se_inkAra_kara	kisI_kArya_ko_jArI_raKane_se_inkAra
pArasala_karane_hewu_bEga	pArasala_karane_hewu_bEga
nOkarI_upalabXa_karAne_vAlI_yoja	nOkarI_upalabXa_karAne_vAlI_yojanA
saMyukwa_kara	saMyukwa
mila_kara	mila_kara
majZAka_kara	majZAka
yAwrA_kara	yAwrA
GodZe_para_savArI_karawe_hue_BAle_se_yuxXa_kara	GodZe_para_savArI_karawe_hue_BAle_se_yuxXa
motara_meM_sEra_kara	motara_meM_sEra
hAWa_kI_saPAI_kara	hAWa_kI_saPAI
wuranwa_mAna_lenA_yA_svIkAra_kara_le	wuranwa_mAna_lenA_yA_svIkAra_kara_lenA
nyAya_karane_kA_aXikAra	nyAya_karane_kA_aXikAra
vilApa_kara	vilApa
nirvAha_kara	nirvAha
bAra_bAra_kahakara_pareSAna_kara	bAra_bAra_kahakara_pareSAna
rakRaka	rakRaka
Jatake_se_bala_lagAkara_Suru_kara	Jatake_se_bala_lagAkara_Suru
majZAka_kara	majZAka
pareSAna_kara	pareSAna
apaharaNa_kara	apaharaNa_kara
apaharaNa_kara	apaharaNa_kara
jAgrawa_kara	jAgrawa
corI_karane_kI_bImArI	corI_karane_kI_bImArI
corI_karane_kI_bImArI_se_pIdZiwa	corI_karane_kI_bImArI_se_pIdZiwa
pareSAna_karane_kA_DaMga	pareSAna_karane_kA_DaMga
Waka_kara_cUra_ho	Waka_kara_cUra
masAjZa_kara	masAjZa
acewa_yA_paCAdZa_kara_xene_vAlA_prahAra	acewa_yA_paCAdZa_kara_xene_vAlA_prahAra
nApasaMxa_kara	nApasaMxa
xaNdavaw_kara	xaNdavaw
nAmiwa_kara	nAmiwa_kara
kadI_mehanawa_kara	kadI_mehanawa
kAmagAra/majaxUrI_karane_vAlA	kAmagAra/majaxUrI_karane_vAlA
anasIKA_SArIrika_Srama_kara	anasIKA_SArIrika_Srama
AlocanA_kara	AlocanA
AlocanA_kara	AlocanA
Soka_prakata_kara	Soka_prakata
ninxA_kara	ninxA
uwaranA/avawaraNa_kara	uwaranA/avawaraNa
pareSAnI_pExA_kara	pareSAnI_pExA
saPalawA_prApwa_kara	saPalawA_prApwa
BUxqSya_kA_nirmANa_kara	BUxqSya_kA_nirmANa
Capa-Capa_kara	Capa-Capa
acAnaka_AkramaNa_kara	acAnaka_AkramaNa
praSaMsA_kara	praSaMsA
AramBa_kara	AramBa
pravarwwana_kara	pravarwwana
kapade_XonA/suKAnA_Ora_presa_kara	kapade_XonA/suKAnA_Ora_presa
kAle_Xana_ko_saPexa_kara	kAle_Xana_ko_saPexa
ArAma_kara	ArAma
praBAviwa_kara	praBAviwa_kara
vyawIwa_kara	vyawIwa
cAla_Suru_kara	cAla_Suru
newqwva_kara	newqwva
vixyA_arjana_kara	vixyA_arjana_kara
vixyA_arjana_kara	vixyA_arjana
wanAva_kama_kara	wanAva_kama
AlocanA_kara	AlocanA
samawala_kara	samawala
ciwwa_kara	ciwwa
sapAta_kara	sapAta
mukwa_kara	mukwa
Bramiwa_kara	Bramiwa
AhlAxiwa_kara	AhlAxiwa
prakASa_kara	prakASa_kara
halkA_kara	halkA
pasaMxa_kara	pasaMxa
wulanA_kara	wulanA
XIme_se_kara	XIme_se
parisamApwa_kara	parisamApwa
ko_samApwa_kara_xe	ko_samApwa_kara_xenA
pIsa_kara_xrava_meM_baxala_xe	pIsa_kara_xrava_meM_baxala_xenA
beca_kara_pEsA_ikaTTA_kara	beca_kara_pEsA_ikaTTA
sUcIbaxXa_kara	sUcIbaxXa
AvArAgarxI_kara	AvArAgarxI
GqNA_kara	GqNA
apane_pakRa_meM_janamawa_wEyAra_kara	apane_pakRa_meM_janamawa_wEyAra
parisImiwa_kara	parisImiwa
sWAna_nirXAraNa_kara	sWAna_nirXAraNa
xarja_kara	xarja
jamA_kara	jamA
bahuwa_samaya_se_kAma_karane_vAlA	bahuwa_samaya_se_kAma_karane_vAlA
icCA_kara	icCA
DIlA_kara	DIlA
pasanxa_kara	pasanxa
pyAra_kara	pyAra
nIcA_kara	nIcA
cikanA_karane_vAlI	cikanA_karane_vAlI
cikanA_karane_vAlI_vaswu	cikanA_karane_vAlI_vaswu
cikanA_kara	cikanA
SAMwa_kara	SAMwa_kara
Cipa_kara_bETa	Cipa_kara_bETanA
loBa_kara	loBa
pAgala_kara	pAgala
AvarXana_kara	AvarXana
xeKareKa_kara	xeKareKa
BaraNa_poRaNa_kara	BaraNa_poRaNa
corI_kara_le	corI_kara_lenA
baxanAma_kara	baxanAma
kAmacorI_kara	kAmacorI
mAlta	mAlta
burA_vyavahAra_kara	burA_vyavahAra
kRawa-vikRawa_kara	kRawa-vikRawa
vyakwa_kara	vyakwa
jodZa_wodZa_kara	jodZa_wodZa
lUtamAra_karanevAle	lUtamAra_karanevAle
prayANa_kara	prayANa
kinAre_kara	kinAre
vivAha_kara	vivAha
badZI_saMKyA_meM_uwpAxana_kara	badZI_saMKyA_meM_uwpAxana
kawle_Ama_kara	kawle_Ama
mAliSa_karane_vAlA	mAliSa_karane_vAlA
mAliSa_karane_kI_xukAna	mAliSa_karane_kI_xukAna
haswamEWuna_kara	haswamEWuna
SAxI_waya_karane_vAlA_vyakwi	SAxI_waya_karane_vAlA_vyakwi
paMjIkqwa_kara	paMjIkqwa
kRawavikRawa_kara	kRawavikRawa
bakavAsa_kara	bakavAsa
maIpola	maIpola
nirNaya_karanA/pawA_lagA	nirNaya_karanA/pawA_lagAnA
nApa_wola_kara	nApa_wola
kAma_meM_haswakRepa_kara	kAma_meM_haswakRepa
kAma_meM_haswakRepa_karane_vAlA	kAma_meM_haswakRepa_karane_vAlA
haswakRepa_karane_meM_lIna_rahanevAlA	haswakRepa_karane_meM_lIna_rahanevAlA
maXyasWa_kA_kAma_kara	maXyasWa_kA_kAma
bIcabacAva_kara	bIcabacAva
bIcabacAva_karane_vAlA	bIcabacAva_karane_vAlA
medikeda	medikeda
wapasyA_kara	wapasyA
se_BeMta_kara	se_BeMta
sAmanA_kara	sAmanA
pUrA_kara_pA	pUrA_kara_pAnA
miSraNa_kara	miSraNa
yAxa_kara	yAxa
TIka_kara	TIka
TIka_karane_vAlA	TIka_karane_vAlA
TIka_kara	TIka
ulleKa_kara	ulleKa
vyApAra_ke_lie_karja_xene_vAlA_aXikoRa	vyApAra_ke_lie_karja_xene_vAlA_aXikoRa
xayA_karake_mAra	xayA_karake_mAranA
vilaya_kara	vilaya
sammohiwa_kara	sammohiwa
gadZabadZI_kara	gadZabadZI
senAyukwa_kara	senAyukwa
nakala_kara	nakala
nakala_karane_vAlA	nakala_karane_vAlA
nakala_kara	nakala
nakala_kara	nakala
KaxAna_meM_kAma_karane_vAlA	KaxAna_meM_kAma_karane_vAlA
KAna_meM_kAma_karane_vAlA	KAna_meM_kAma_karane_vAlA
CotA_kara	CotA
sevA_kara	sevA
xurupayoga_kara	xurupayoga
gabana_kara	gabana
burA_vyahavAra_kara	burA_vyahavAra
SEwAnI_kara	SEwAnI
anarWa_kara	anarWa
galawa_DaMga_se_prayoga_kara	galawa_DaMga_se_prayoga
paWaBraRta_kara	paWaBraRta
galawaPahamI_pExA_karanevAlA	galawaPahamI_pExA_karanevAlA
kuprabanXa_kara	kuprabanXa
Orawa_jAwi_se_naParawa_karane_vAlA_AxamI	Orawa_jAwi_se_naParawa_karane_vAlA_AxamI
galawa_uccAraNa_kara	galawa_uccAraNa
galawa_prawiniXiwva_kara	galawa_prawiniXiwva
kamI_mahasUsa_kara	kamI_mahasUsa
misAila	misAila
Xarma_pracAra_karane_vAlA	Xarma_pracAra_karane_vAlA
galawa_Karca_kara	galawa_Karca
galawa_samaya_para_kara	galawa_samaya_para
galawa_vyavahAra_kara	galawa_vyavahAra
aviSvAsa_kara	aviSvAsa
gamBIrawA_kama_kara	gamBIrawA_kama
gamBIrawA_kama_karane_vAlA	gamBIrawA_kama_karane_vAlA
gamBIrawA_kama_kara_xe	gamBIrawA_kama_kara_xenA
miSraNa_kara	miSraNa
miksara/miSra_karanevAlA_yaMwra	miksara/miSra_karanevAlA_yaMwra
Soka_kara	Soka
gawiSIla_kara	gawiSIla
XImA_kara	XImA_kara
AXunikaraNa_kara	AXunikaraNa
nama_kara	nama
sawAnA/CedZaCAdZa_kara	sawAnA/CedZaCAdZa
CedZaCAdZa_karanevAlA	CedZaCAdZa_karanevAlA
SAMwa_kara	SAMwa
bowala_meM_petrola_Bara_kara_banAyA_visPotaka	bowala_meM_petrola_Bara_kara_banAyA_visPotaka
anwa_ke_karIba	anwa_ke_karIba
lajjiwa_kara	lajjiwa
pravarwana_kara	pravarwana_kara
iSArA_kara	iSArA
preriwa_kara	preriwa
motara_sajjiwa_kara	motara_sajjiwa
caDZa_kara_bETa	caDZa_kara_bETanA
rakRaka_jEsA_vyavahAra_kara	rakRaka_jEsA_vyavahAra
Soka_karanA/xuHKI_ho	Soka_karanA/xuHKI
sWAnAnwariwa_kara	sWAnAnwariwa
praswAviwa_kara	praswAviwa
uwsAhiwa_kara	uwsAhiwa
yAwrA_SurU_kara	yAwrA_SurU
viRaya_parivarwana_karanA/sWAna_parivarwana_kara	viRaya_parivarwana_karanA/sWAna_parivarwana
jalxI_kara	jalxI
yAwrA_SurU_kara	yAwrA_SurU
sammAna_kara	sammAna
vicAra_kara	vicAra_kara
_vicAra_kara	_vicAra
cinwana_kara	cinwana
gaMxA_kara	gaMxA
GabarAhata_se_SurU_kara	GabarAhata_se_SurU
aXyayana_kara	aXyayana
para_vicAra_kara	para_vicAra
guNA_kara	guNA
Sava_kA_parirakRaNa_kara	Sava_kA_parirakRaNa
nagarapAlikA_ke_aXIna_kara	nagarapAlikA_ke_aXIna
ikaTTA_kara	ikaTTA
balavA_kara	balavA
vixroha_kara	vixroha
pecIxA_kara	pecIxA
waMga_kara	waMga
nAKUna_sAPa_karane_kA_braSa	nAKUna_sAPa_karane_kA_braSa
niyukwa_kara	niyukwa
bayAna_kara	bayAna
bayAna_karane_vAlA	bayAna_karane_vAlA
parimiwa_yA_waMga_kara	parimiwa_yA_waMga
rARtrIyakaraNa_kara	rARtrIyakaraNa
majabUra_kara	majabUra
pareSAna_kara	pareSAna_kara
silAI_karanevAlI	silAI_karanevAlI
upekRA_kara	upekRA
molaBAva_karane_lAyaka	molaBAva_karane_lAyaka
mola_wola_kara	mola_wola
pAra_kara	pAra
mola_wola_karanevAlA	mola_wola_karanevAlA
Sakwi_praxAna_kara	Sakwi_praxAna
cinwA_karane_vAlA	cinwA_karane_vAlA
niRpraBAva_kara	niRpraBAva
Cexa_kara	Cexa
nukwAcInI_kara	nukwAcInI
jalxI_kara	jalxI
nAmAMkiwa_kara	nAmAMkiwa
anupAlana_na_kara	anupAlana_na
aMSaxAna_na_kara	aMSaxAna_na
BugawAna_na_kara	BugawAna_na
kiMkarwavyavimUDa_kara	kiMkarwavyavimUDa
pAlana_/poRaNa_kara	pAlana_/poRaNa
raxxa_kara	raxxa
sunna_kara_xe	sunna_kara_xenA
upacaryA_kara	upacaryA
sUzganA_yA_sUzgakarapyAra_kara	sUzganA_yA_sUzgakarapyAra
AjFApAlana_kara	AjFApAlana
samaJa_ke_pare_kara	samaJa_ke_pare
Apawwi_vyakwa_kara	Apawwi_vyakwa
maxaxa_karane_upakqwa_kara	maxaxa_karane_upakqwa
nEwika_niyamoM_se_majZabUra_kara	nEwika_niyamoM_se_majZabUra
pUrA_bUJAz_xenA/naRta_kara	pUrA_bUJAz_xenA/naRta
XuzXalA_kara_xe	XuzXalA_kara_xenA
boJawma_kara_xe	boJawma_kara_xenA
XyAna_se_xeKa	#nirIkRaNa_karanA	XyAna_se_xeKanA #nirIkRaNa
manA	manAnA
pAlana_kara	pAlana
apanA_mawa_vyakwa_kara	apanA_mawa_vyakwa
prApwa_kara	prApwa
kabjZA_kara	kabjZA
aprasanna_kara	aprasanna
praxAna_kara	praxAna
kisI_paxa_para_kAma_kara	kisI_paxa_para_kAma
prAraMBa_kara	prAraMBa
AramBa_kara	AramBa
kAma_kara	kAma
cIra_PAdZa_kara	cIra_PAdZa
viroXa_kara	viroXa
xamana_kara	xamana
aBiReka_kara	aBiReka
Ayojiwa_kara	Ayojiwa
saMgaTiwa_kara	saMgaTiwa
AraMBa_honA_yA_kara	AraMBa_honA_yA
viBURiwa_kara	viBURiwa
dola	dola
bahiRkqwa_kara	bahiRkqwa
kisI_se_jyAxA_behawara_kAma_kara	kisI_se_jyAxA_behawara_kAma
pare_hatakara_pICe_se_hamalA_kara	pare_hatakara_pICe_se_hamalA
bahiRkqwa_kara	bahiRkqwa
rUpareKA_AreKiwa_kara	rUpareKA_AreKiwa
se_behawara_kAma_kara	se_behawara_kAma
prakRepaNa_kara	prakRepaNa
prakRubXa_kara	prakRubXa
hakkAbakkA_karanevAlA	hakkAbakkA_karanevAlA
hoSiyArI_se_hAsila_kara	hoSiyArI_se_hAsila
saMpUrNa_marammawa_kara	saMpUrNa_marammawa
kqwrima_aBinaya_kara	kqwrima_aBinaya
pUrNawaH_praBAviwa_kara	pUrNawaH_praBAviwa
manamAnI_karanevAlA	manamAnI_karanevAlA
jarUrawa_se_jyAxA_ArakRaNa_kara	jarUrawa_se_jyAxA_ArakRaNa
vaSIBUwa_kara_le	vaSIBUwa_kara_lenA
kamI_pUrI_kara	kamI_pUrI
awi_kara_xe	awi_kara_xenA
wejZa_gawi_karane_vAlA_giyara	wejZa_gawi_karane_vAlA_giyara
nirIkRaNa_kara	nirIkRaNa
bahuwa_garma_kara	bahuwa_garma
jisameM_jarUrawa_se_jyAxA_karmacArI_Bare_hoM	jisameM_jarUrawa_se_jyAxA_karmacArI_Bare_hoM
pAra_karanA/2.AzKa_CipAnA/3.BUla	pAra_karanA/2.AzKa_CipAnA/3.BUlanA
niyanwraNa_kara	niyanwraNa
aXika_mUlyAMkana_kara	aXika_mUlyAMkana
prawikriyA_kara	prawikriyA
niraswa_kara_xe	niraswa_kara_xenA
raxa_kara_xe	raxa_kara_xenA
nirIkRaNa_kara	nirIkRaNa
sAyA_kara	sAyA
baDZA_caDZA_kara_kaha	baDZA_caDZA_kara_kahanA
awikramaNa_kara	awikramaNa_kara
aXika_mAwrA_meM_saMcaya_kara	aXika_mAwrA_meM_saMcaya
gAnA_prAramBa_karane_kA_gIwa	gAnA_prAramBa_karane_kA_gIwa
ulata_xenA/2.parAjiwa_karanA/3.barabAxa_karanA/naRta_karanA/ulata_palata_kara	ulata_xenA/2.parAjiwa_karanA/3.barabAxa_karanA/naRta_karanA/ulata_palata
aXika_BAvanA_prakata_kara	aXika_BAvanA_prakata
awyanwa_pariSrama_kara	awyanwa_pariSrama
cahalakaxamI_kara	cahalakaxamI
SAMwa_kara	SAMwa
SAMwi_karaNa	SAMwi_karaNa
SAMwa_karanevAlA	SAMwa_karanevAlA
pEka_karane_ke_liye_dibbA	pEka_karane_ke_liye_dibbA
ciwrakArI_kara	ciwrakArI
kama_kara	kama
bahuwa_lAdZa_pyAra_kara	bahuwa_lAdZa_pyAra
kutanAI_kara	kutanAI
pawra_karwaka	pawra_karwaka
praxarSana_kara	praxarSana_kara
paxAnvaya_kara	paxAnvaya
mAPa_kara	mAPa
carca_kI_karmacArI	carca_kI_karmacArI
gAdZI_KadA_kara	gAdZI_KadA
saMXi_vArwA_kara	saMXi_vArwA
aMXAnukaraNa_kara	aMXAnukaraNa
haswAMwariwa_kara	haswAMwariwa
pAra_kara	pAra
sahana_kara	sahana
ho_kara/se	ho_kara/se
sanaxa_xekara_aXikAra_kI_rakRA_kara	sanaxa_xekara_aXikAra_kI_rakRA
saMrakRaNa_kara	saMrakRaNa
anukaraNa_kara	anukaraNa
mArga_TIka_kara	mArga_TIka
cApalUsI_kara	cApalUsI
jo_BugawAna_karanA_cAhie	jo_BugawAna_karanA_cAhie
saMXAwA/saMXi_karAnevAlA	saMXAwA/saMXi_karAnevAlA
pEroM_kI_saPZAI_kara	pEroM_kI_saPZAI
peSAba_kara	peSAba
wAzka-JAzka_karanevAlA	wAzka-JAzka_karanevAlA
cIM-cIM_kara	cIM-cIM
bAdZe_meM_banxa_kara	bAdZe_meM_banxa
xaNdZiwa_kara	xaNdZiwa
ciwriwa_kara	ciwriwa
penI	penI
owa_prewa_kara	owa_prewa
meVhasUsa_kara	meVhasUsa
jalxI_jFAna_grahaNa_karanevAlA	jalxI_jFAna_grahaNa_karanevAlA
jalxI_grahaNa_karane_yogya	jalxI_grahaNa_karane_yogya
bUMxa_bUMxa_karake_tapaka	bUMxa_bUMxa_karake_tapakanA
paripUrNa_kara	paripUrNa
praxarSana_kara	praxarSana
kAma_kara	kAma
SIGrawA_ke_sAWa_TIka-TAka_kAma_karane_kI_kRamawA	SIGrawA_ke_sAWa_TIka-TAka_kAma_karane_kI_kRamawA
sugaMXiwa_kara	sugaMXiwa
KuSabU_se_BarapUra_karaxe	KuSabU_se_BarapUra_karaxenA
pApa_yA_xoRa_kara	pApa_yA_xoRa
aparAXa_karma	aparAXa_karma
pApa_karma_karane_vAlA	pApa_karma_karane_vAlA
vyAkula_kara	vyAkula
uwpIdiwa_kara	uwpIdiwa
niranwara_prayawna_karawe_raha	niranwara_prayawna_karawe_rahanA
niranwara_prayawna_kara	niranwara_prayawna
mAnavIkaraNa_kara	mAnavIkaraNa
vicAra_prakata_kara	vicAra_prakata
rAjZI_kara	rAjZI_kara
ke_lie_rAjI_kara	ke_lie_rAjI
uxvigna_kara_xe	uxvigna_kara_xenA
anuSIlana_kara	anuSIlana
xurupayoga_kara	xurupayoga
paWaBraRta_kara	paWaBraRta
paWa_BraRta_karanevAlA	paWa_BraRta_karanevAlA
waMga_karane_vAlA	waMga_karane_vAlA
pareSAna_karanevAlA	pareSAna_karanevAlA
cidacidA_kara	cidacidA_kara
caraNoM_meM_kara	caraNoM_meM
kramaSaH_samApwa_kara	kramaSaH_samApwa
irakabAjZI_kara	irakabAjZI
tikata_saMgrahaNa_karane_kA	tikata_saMgrahaNa_karane_kA
xArSanika_rUpa_meM_praswuwa_kara	xArSanika_rUpa_meM_praswuwa
PZona_kara	PZona
sAPZa_kara	sAPZa
kalpanA_kara	kalpanA
ciwriwa_karanA/ciwra_xvArA_praxarSiwa_kara	ciwriwa_karanA/ciwra_xvArA_praxarSiwa
peSAba_kara	peSAba
WodA-WodA_karake	WodA-WodA_karake
Cexiwa_kara	Cexiwa
praBAviwa_kara	praBAviwa
sArvajanika_rUpa_se_xaMdiwa_kara	sArvajanika_rUpa_se_xaMdiwa
prayoga_kara	prayoga
corI_kara	corI
lAlasA_kara	lAlasA
Sora_kara	Sora
mArga_praSaswa_kara	mArga_praSaswa
mArga_praSaswa_karanevAlA	mArga_praSaswa_karanevAlA
mUwanA/peSAba_kara	mUwanA/peSAba
jabaraxaswI_kisI_se_koI_kAma_karavA	jabaraxaswI_kisI_se_koI_kAma_karavAnA
sWira_kara	sWira
SAMwa_kara	SAMwa
sAhiwyika_corI_kara	sAhiwyika_corI
patarioM_kA_marammawa_karanevAlA	patarioM_kA_marammawa_karanevAlA
niruwsAha_se_kara	niruwsAha_se
niruwsAha_se_kara	niruwsAha_se
apne_lABa_ke_lie_mukZAbalA_karavA	apne_lABa_ke_lie_mukZAbalA_karavAnA
yAcanA_kara	yAcanA
KuSa_kara	KuSa_kara
prawijFA_kara	prawijFA_kara
prawijFA_kara	prawijFA
pariSrama_se_karanevAlA	pariSrama_se_karanevAlA
CapAka_kI_Xvani_kara	CapAka_kI_Xvani
iSArA_kara	iSArA
niSAnA_bAzXanA/lakRya_kara	niSAnA_bAzXanA/lakRya
tIpa_kara	tIpa
lakRya_karawe_hue	lakRya_karawe_hue
saMwuliwa_kara	saMwuliwa
xURiwa_kara_xe	xURiwa_kara_xenA
XUpa_kI_wIvrawA_kama_karanevAlA_AvaraNa	XUpa_kI_wIvrawA_kama_karanevAlA_AvaraNa
vota_prApwa_kara	vota_prApwa
mawagrahaNa_kara	mawagrahaNa
apaviwra_kara	apaviwra
socanA/manana_karanA/cinwana_kara	socanA/manana_karanA/cinwana
XarmAcArya_kI_waraha_bAweM_kara	XarmAcArya_kI_waraha_bAweM
wiraskAra_kara	wiraskAra
ikatTA_kara	ikatTA
pariSIlana_kara	pariSIlana
ciwraNa_kara	ciwraNa_kara
aBinaya_kara	aBinaya
ciwriwa_kara	ciwriwa
praswuwa_kara	praswuwa
kA_DoMga_racanA/xiKAvA_kara	kA_DoMga_racanA/xiKAvA
niyukwa_kara	niyukwa
uwwara_xinAMkiwa_kara	uwwara_xinAMkiwa
aBiXAraNA_kara	aBiXAraNA
xiKAvA_kara	xiKAvA
aByAsa_kara	aByAsa
praSaMsA_kara	praSaMsA
swuwi_kara	swuwi
bakabaka_kara	bakabaka
bakabaka_kara	bakabaka
prArWanA_kara	prArWanA
ASA_kara	ASA
preriwa_kara	preriwa
prawibanXiwa_kara	prawibanXiwa
pUrvaniScaya_kara	pUrvaniScaya
pUrva_pravaNa_kara	pUrva_pravaNa
avaroXa_kara	avaroXa
prAraMBa_honA_yA_kara	prAraMBa_honA_yA
pasanxa_kara	pasanxa
pUrvakalpanA_kara	pUrvakalpanA
culhA_ko_garama_kara	culhA_ko_garama
pUrvarUpeNa_XyAna_AkarRiwa_kara	pUrvarUpeNa_XyAna_AkarRiwa
wEyAra_kara	wEyAra
praBAviwa_kara	praBAviwa_kara
nirXAriwa_kara	nirXAriwa
praswuwa_kara	praswuwa
saMcAlana_kara	saMcAlana
iswrI_kara	iswrI
sAhasa_kara	sAhasa
aBinaya_kara	aBinaya
Cala_kapata_kara	Cala_kapata
SikAra_karana	SikAra_karana
mUlya_nirXAriwa_kara	mUlya_nirXAriwa
JunaJunI_pExA_karane_vAlA	JunaJunI_pExA_karane_vAlA
garva_kara	garva
wEyAra_kara	wEyAra
bala_se_alaga_kara	bala_se_alaga
saMpramANiwa_kara	saMpramANiwa
jAzca_padawAla_kara	jAzca_padawAla
saMsAXiwa_kara	saMsAXiwa
saMsAXiwa_karane_kA_yanwra	saMsAXiwa_karane_kA_yanwra
GoRiwa_kara	GoRiwa
pramANiwa_kara	pramANiwa
vilamba_kara	vilamba
prajanana_kara	prajanana
prApwa_kara	prApwa
xalAlI_kara	xalAlI
uwpAxana_kara	uwpAxana
racanA_kara	racanA
parisWiwi_uwpanna_kara	parisWiwi_uwpanna
praswuwa_kara	praswuwa
anAxara_kara	anAxara
xAvA_kara	xAvA
Kule_Ama_svIkAra_kara	Kule_Ama_svIkAra
niReXa_kara	niReXa
pariyojanA_kara	pariyojanA
pracura_mAwrA_meM_uwpanna_honA_yA_kara	pracura_mAwrA_meM_uwpanna_honA_yA
lambA_kara	lambA
lambA_kara	lambA
prawijFA_kara	prawijFA
paxonnawi_kara	paxonnawi
pracAra_kara	pracAra
preriwa_kara	preriwa
anuboXana_karanevAlA	anuboXana_karanevAlA
GoRiwa_kara	GoRiwa
uccAraNa_kara	uccAraNa
prUP-SoXana_kara	prUP-SoXana
pracAra_kara	pracAra
noxana_kara	noxana
BaviRyavANI_karawe_hue	BaviRyavANI_karawe_hue
prasAxiwa_kara	prasAxiwa
praswuwa_kara	praswuwa
aBiniRixXa_kara	aBiniRixXa
aBiyoga_kara	aBiyoga
xaNdavaw_kara	xaNdavaw
rakRA_kara	rakRA
viroXa_kara	viroXa
sixXa_kara	sixXa
kruxXa_kara	kruxXa
wAka_JAzka_kara	wAka_JAzka
praBAviwa_kara	praBAviwa
Bramiwa_karane_vAlA	Bramiwa_karane_vAlA
pracAra_kara	pracAra
prakASiwa_kara	prakASiwa
ulatI_kara	ulatI
AkarRiwa_kara	AkarRiwa
gEra_kAnUnI_kArya_kara	gEra_kAnUnI_kArya
giraPwAra_kara	giraPwAra
maxaxa_kara	maxaxa
milakara_kAma_kara	milakara_kAma
niyanwriwa_kara	niyanwriwa
ninxA_kara	ninxA
vinaRta_kara	vinaRta
SuxXa_kara	SuxXa
SuxXa_kara	SuxXa
xAvA_kara	xAvA
pICA_kara	pICA
prabanXa_kara	prabanXa
vyakwa_kara	vyakwa
Garra-Garra_kara	Garra-Garra
cAra_mArgoM_se_Xvani_saMcAriwa_karane_kI_vyavasWA	cAra_mArgoM_se_Xvani_saMcAriwa_karane_kI_vyavasWA
cOgunA_karanA_yA_ho	cOgunA_karanA_yA_ho
saMgaroXa_kara	saMgaroXa
JagadA_kara	JagadA
cAra_sama_BAga_kara	cAra_sama_BAga
xamana_kara	xamana
rAnI_jEsA_vyavahAra_kara	rAnI_jEsA_vyavahAra
gadZabadZa_kara	gadZabadZa
praSna_kara	praSna
praSna_kara	praSna_kara
bahAnA_kara	bahAnA_kara
jalxI_kara	jalxI_kara
SAMwa_kara	SAMwa
SAnwa_kara	SAnwa
pacagunA_kara	pacagunA_kara
uxXqwa_kara	uxXqwa
lambI-cOdZI_bAweM__kara	lambI-cOdZI_bAweM_
Barasaka_prayAsa_kara	Barasaka_prayAsa
rediyo_XarmI_paxArWa_kI_sahAyawA_se_ilAja_karA	rediyo_XarmI_paxArWa_kI_sahAyawA_se_ilAja_karAnA
caMxA_ekawra_kara_ke_mOja-maswI_kara	caMxA_ekawra_kara_ke_mOja-maswI
CedZa-CAdZa_kara	CedZa-CAdZa
rela_para_saPZara_kara	rela_para_saPZara
rela_karmacArI	rela_karmacArI
KadZA_kara	KadZA
vqxXi_karanA_/baDZA	vqxXi_karanA_/baDZAnA
ekawra_kara	ekawra
uwpanna_kara	uwpanna
badZA_kara	badZA
GqNA_prakata_kara	GqNA_prakata
viroXa_kara	viroXa
pAzcA	pAzcA
jamA_kara	jamA
walASa_kara	walASa
ekawriwa_kara	ekawriwa
lABa_kara	lABa
kasanA/BidZanAra/jAnabUJa_kara_xUsarI_gAdZI_se_takarAnA/TUzsa	kasanA/BidZanAra/jAnabUJa_kara_xUsarI_gAdZI_se_takarAnA/TUzsanA
asaMgawa_bAweM_karanA_yA_liKa	asaMgawa_bAweM_karanA_yA_liKanA
sEra_sapAtA_karane_vAlA	sEra_sapAtA_karane_vAlA
mAra_kara_saka	mAra_kara_sakanA
hallA_macAkara_xoRAropaNa_kara	hallA_macAkara_xoRAropaNa
balAwkAra_kara	balAwkAra
balAwkAra_karanevAlA	balAwkAra_karanevAlA
kama_GanA_honA/pawalA_karanA_yA_ho	kama_GanA_honA/pawalA_karanA_yA
kAta_CAzta_kara_rewI_se_cikanA_kara	kAta_CAzta_kara_rewI_se_cikanA
Ane_vAle_saMkata_kI_ASaMkA_kara	Ane_vAle_saMkata_kI_ASaMkA
gussA_prakata_kara	gussA_prakata
mUlyAkaMna_kara	mUlyAkaMna
nirXAriwa_kara	nirXAriwa
pramANiwa_kara	pramANiwa
pUrwi_sImiwa_kara	pUrwi_sImiwa
kroXiwa_hokara_bAwa_kara	kroXiwa_hokara_bAwa
praSaMsA_kara	praSaMsA
pracaNdawA_se_SikAra_kara	pracaNdawA_se_SikAra
mohiwa_kara	mohiwa
pUrI_waraha_naSta_kara_xe	pUrI_waraha_naSta_kara_xenA
punaH_sWApiwa_kara	punaH_sWApiwa
prawikriyA_kara	prawikriyA
rAsAyanika_parivarwana_pExA_kara	rAsAyanika_parivarwana_pExA
kisI_paxArWa_me_parivarwana_kara	kisI_paxArWa_me_parivarwana
Pira_se_sakriya_kara	Pira_se_sakriya
aXyayana_kara	aXyayana
Pira_TIka_kara	Pira_TIka
puRti_kara	puRti
AScarya_prakata_kara	AScarya_prakata
jEsI_karanI_vEsI_BaranI	jEsI_karanI_vEsI_BaranI
Pira_se_niyukwa_kara	Pira_se_niyukwa
pAlana_poRaNa_kara	pAlana_poRaNa
warka_kara	warka
warka_karane_vAlA	warka_karane_vAlA
bAwa_ko_Pira_kZAyama_kara	bAwa_ko_Pira_kZAyama
CUta_xenA_kama_kara	CUta_xenA_kama
vixroha_kara	vixroha
KaNdana_kara	KaNdana
yAxa_kara	yAxa_kara
raxxa_kara	raxxa
svAgawa_kara	svAgawa
grahaNa_karane_kA_DZaMga	grahaNa_karane_kA_DZaMga
axalA_baxalI_kara	axalA_baxalI
vyAKyAna_kara	vyAKyAna
punaH_prApwa_kara	punaH_prApwa
viroXa_kara	viroXa
smaraNa_kara	smaraNa
Pira_se_AramBa_kara	Pira_se_AramBa
praSaMsA_kara	praSaMsA
mela_karanA_vA_karA	mela_karanA_vA_karAnA
sahI_kara_le	sahI_kara_lenA
Pira_se_bETAnA_yA_TIka_kara	Pira_se_bETAnA_yA_TIka
punargaTana_kara	punargaTana
Pira_se_banAnA_yA_nirmANa_kara	Pira_se_banAnA_yA_nirmANa
rekArda_kara	rekArda_kara
rajistara_mez_xarja_kara	rajistara_mez_xarja
aMkiwa_kara	aMkiwa
progrAma_ko_tepa_kara	progrAma_ko_tepa
bayAna_kara	bayAna
kRawi_pUrwi_kara	kRawi_pUrwi
barAmaxa_kara	barAmaxa
vasUla_kara	vasUla
punaH_svAsWya_lABa_kara	punaH_svAsWya_lABa
Pira_uwpanna_kara	Pira_uwpanna
nayI_BarwI_kara	nayI_BarwI
TIka_kara	TIka
punaH_prApwa_kara	punaH_prApwa
xOrA_karane_vAlA	xOrA_karane_vAlA
lAla_kara	lAla_kara
lAla_karanA_yA_ho	lAla_karanA_yA
kRawi_pUrwi_kara	kRawi_pUrwi
BugawAna_karake_mukwa_karA	BugawAna_karake_mukwa_karAnA
BugawAna_karake_vApasa_liyA_jA_sake	BugawAna_karake_vApasa_liyA_jA_sake
punaH_vikAsa_kara	punaH_vikAsa
anupreRiwa_kara	anupreRiwa
punaH_viwaraNa_kara	punaH_viwaraNa
xobArA_kara	xobArA
xugunA_kara	xugunA_kara
xoharAnA/aXika_balavawI_kara	xoharAnA/aXika_balavawI
palata_kara_A	palata_kara_AnA
sahI_kara	sahI
jahAjZa_ke_pAla_ko_kama_kara	jahAjZa_ke_pAla_ko_kama
saMkewa_kara	saMkewa
nyAya_karane_vAlA	nyAya_karane_vAlA
nirmala_kara	nirmala
sAPZa_karane_vAlA	sAPZa_karane_vAlA
XAwu_iwyAxi_sAPZa_karane_kA_sWAna_yA_yanwra	XAwu_iwyAxi_sAPZa_karane_kA_sWAna_yA_yanwra
Pira_xuruswa_kara	Pira_xuruswa
parAvarwiwa_kara	parAvarwiwa
cinwana_yA_vicAra_kara	cinwana_yA_vicAra
roka	rokanA
roka	rokanA
wAjA_kara	wAjA
wAjZA_karane_vAlA	wAjZA_karane_vAlA
TaNdA_karane_vAlA	TaNdA_karane_vAlA
TaNdA_kara	TaNdA
TaNdA_kara	TaNdA
vApasa_kara	vApasa
asvIkAra_kara	asvIkAra
KaNdana_kara	KaNdana
punaH_prApwa_kara	punaH_prApwa
prasanna_kara	prasanna
Axara_kara	Axara
Pira_pExA_kara	Pira_pExA
rajistara_kara	rajistara_kara
xarja_kara	xarja
paMjIkqwa_karA	paMjIkqwa_karAnA
praxarSiwa_kara	praxarSiwa
sivila_vivAha_karane_kA_kAryAlaya	sivila_vivAha_karane_kA_kAryAlaya
paScAwApa_kara	paScAwApa
niyamiwa_kara	niyamiwa
prabanXa_karwA	prabanXa_karwA
jugAlI_kara	jugAlI
punarvAsiwa_kara	punarvAsiwa
aByAsa_kara	aByAsa
SAsana_kara	SAsana
axA_kara	axA
punaH_lAgU_kara	punaH_lAgU_kara
naI_senA_se_sahAyawA_kara	naI_senA_se_sahAyawA
suxqDZa_yA_majabUwa_kara	suxqDZa_yA_majabUwa
sImeMta_Ora_kaMkarIta_ko_lohe_kI_CadZoM_se_majabUwI_praxAna_kara	sImeMta_Ora_kaMkarIta_ko_lohe_kI_CadZoM_se_majabUwI_praxAna
Pira_se_niyukwa_kara	Pira_se_niyukwa
Pira_se_vyAKyA_kara	Pira_se_vyAKyA
punaH_lAgU_kara	punaH_lAgU
parivarwana_karake_nayApana_lA	parivarwana_karake_nayApana_lAnA
punaH_cAlU_karane_kI_kriyA	punaH_cAlU_karane_kI_kriyA
Pira_jArI_kara	Pira_jArI
asvIkAra_kara	asvIkAra
prasanna_karanA_yA_ho	prasanna_karanA_yA
nayA_kara	nayA
Pira_roSana_kara	Pira_roSana
varNana_kara	varNana
hamaxarxI_prakata_kara	hamaxarxI_prakata
punaH_sWApiwa_kara	punaH_sWApiwa
DIlA_kara	DIlA_kara
viSrAma_kara	viSrAma_kara
kama_kara	kama
Pira_batoranA_vA_jamA_kara	Pira_batoranA_vA_jamA
mukwa_kara	mukwa
vimocana/lokArpaNa_kara	vimocana/lokArpaNa
mocana_kara	mocana
avanawi_kara	avanawi
BarosA_karane_vAlA	BarosA_karane_vAlA
pIdZA_kama_kara	pIdZA_kama
sevA_se_mukwa_kara	sevA_se_mukwa
kama_kara	kama
kArya_mukwa_kara	kArya_mukwa
sahAyawA_kara	sahAyawA
viSvAsa_kara	viSvAsa
nirBara_kara	nirBara
tippaNI_kara	tippaNI
Pira_se_vivAha_kara	Pira_se_vivAha
prawikAra_karane_vAlA	prawikAra_karane_vAlA
yAxa_kara	yAxa_kara
yAxa_karanA/na_BUla	yAxa_karanA/na_BUlanA
yAxa_karAne_vAlA	yAxa_karAne_vAlA
Apawwi_kara	Apawwi
xUra_kara	xUra
alaga_kara	alaga
anwa_kara	anwa
viBAjana_kara	viBAjana
rUpAMwariwa_kara	rUpAMwariwa
arpaNa_kara	arpaNa
anuvAxa_kara	anuvAxa
praxarSiwa_kara	praxarSiwa
vAyaxA_karake_mukara_jA	vAyaxA_karake_mukara_jAnA
navIyana_kara	navIyana
asvIkAra_kara	asvIkAra
kirAyA_lekara_prayoga_karane_kA_aXikAra_praxAna_kara	kirAyA_lekara_prayoga_karane_kA_aXikAra_praxAna
punaH_prApwa_karanA-3	punaH_prApwa_karanA-3
punaH_saMgaTiwa_kara	punaH_saMgaTiwa
marammawa_kara	marammawa_kara
marammawa_kara	marammawa
raxxa_kara	raxxa
mukAbalA_kara	mukAbalA
baxale_me_kuCa_kara	baxale_me_kuCa
SikAyawa_kara	SikAyawa
varNana_kara	varNana
ArAma_kara	ArAma
ArAma_kara	ArAma
BarosA_kara	BarosA
Pira_aXikAra_kara	Pira_aXikAra
punaH_aXikAra_prApwa_kara	punaH_aXikAra_prApwa_kara
xoRAropaNa_karane_yogya	xoRAropaNa_karane_yogya
prawiniXiwva_kara	prawiniXiwva
praxarSana_kara	praxarSana
ciwriwa_kara	ciwriwa
5'varNana__kara	5'varNana_
xubArA_upasWiwa_kara	xubArA_upasWiwa
Pira_pExA_kara	Pira_pExA
uwpanna_kara	uwpanna
prawilipi_karane_para_viSeRa_guNa_banAye_raKa	prawilipi_karane_para_viSeRa_guNa_banAye_raKanA
sanwAna_uwpanna_kara	sanwAna_uwpanna
wyAga_kara	wyAga
nAmaMjUra_kara	nAmaMjUra
anuroXa_kara	anuroXa
icCA_kara	icCA
mAzga_praswuwa_kara	mAzga_praswuwa
raxxa_kara	raxxa
SoXa_kara	SoXa
ArakRiwa_kara	ArakRiwa
Pira_basanA_yA_waya_kara	Pira_basanA_yA_waya
Pere_baxala_kara	Pere_baxala
Pera-baxala_kara	Pera-baxala
supurxa_kara	supurxa
viroXa_kara	viroXa
samAXAna_kara	samAXAna_kara
niScaya_kara	niScaya
hala_kara	hala
parivarwana_kara	parivarwana
mawaxAna_xvArA_koI_samarWana_kara	mawaxAna_xvArA_koI_samarWana
prawiXvaniwa_karane_vAlA	prawiXvaniwa_karane_vAlA
sammAna_kara	sammAna
praSaMsA_kara	praSaMsA
vilamba_kara	vilamba
prawikriyA_kara	prawikriyA
baxale_me_kuCa_karanA_yA_kaha	baxale_me_kuCa_karanA_yA_kahanA
ArAma_kara	ArAma
SAnwi_praxAna_kara	SAnwi_praxAna
GUra_kara_xeKa	GUra_kara_xeKanA
marammawa_karanA/jIrNoxXAra	marammawa_karanA/jIrNoxXAra
jyoz_kA_wyoz_kara	jyoz_kA_wyoz
marammawa_kara	marammawa
bahAla_kara	bahAla
bahAla_karane_vAlA	bahAla_karane_vAlA
svawaMwrawA_kA_hanana_kara	svawaMwrawA_kA_hanana
parimiwa/sImiwa_kara	parimiwa/sImiwa
hodZa_kama_karane_kA_samaJOwA	hodZa_kama_karane_kA_samaJOwA
Pira_AramBa_kara	Pira_AramBa
punarjIviwa_kara	punarjIviwa
avakASa_prApwa_kara	avakASa_prApwa
kama_kara	kama
prawikAra_kara	prawikAra
punaH_prApwa_karanA-4	punaH_prApwa_karanA-4
punaH_prApwa_kara	punaH_prApwa
bIwI_huI_bAwoz_para_kAma_karane_vAlA	bIwI_huI_bAwoz_para_kAma_karane_vAlA
punarAvalokana_kara	punarAvalokana
vApisa_karanA/lOtA	vApisa_karanA/lOtAnA
lABa_praxAna_kara	lABa_praxAna
punaH_prayoga_kara	punaH_prayoga
punaH_mUlyAMkana_kara	punaH_mUlyAMkana
punaH_mUlyAMkana_karane_kI_kriyA	punaH_mUlyAMkana_karane_kI_kriyA
navIkaraNa_kara	navIkaraNa
prakata_kara	prakata
Amoxa_pramoxa_kara	Amoxa_pramoxa
Axara_kara	Axara
ninxA_kara	ninxA_kara
Pira_Bezta_kara	Pira_Bezta
Pira_jIviwa_kara	Pira_jIviwa
KaNdana_kara	KaNdana
raxxa_kara	raxxa
raxXa_kara	raxXa
GqNA_uwpanna_kara	GqNA_uwpanna_kara
punaH_kArya_kara	punaH_kArya
wukabaMxI_kara	wukabaMxI
waMga_karanA/majAka_banA	waMga_karanA/majAka_banAnA
mukwa_kara	mukwa
bahuwa_se_Cexa_kara	bahuwa_se_Cexa
savArI_kara	savArI
upahAsa_kara	upahAsa
upakaraNa_se_lesa_kara	upakaraNa_se_lesa
cAlAkI_se_saMcAliwa_kara	cAlAkI_se_saMcAliwa
xaMgA_kara	xaMgA
xaMgA_karane_vAlA	xaMgA_karane_vAlA
unnawi_kara	unnawi
barAbarI_kara	barAbarI
AkqRta_kara	AkqRta
mArga_kara	mArga_kara
CixrAnveRaNa_kara	CixrAnveRaNa
saBAvaswra_XAraNa_kara	saBAvaswra_XAraNa
yaMwravawa_kAma_karanevAlA	yaMwravawa_kAma_karanevAlA
uCala_kUxa_kara	uCala_kUxa
sWApiwa_kara	sWApiwa_kara
kAma_karane_vAloz_kI_nAmAvalI	kAma_karane_vAloz_kI_nAmAvalI
uwwejiwa_kara	uwwejiwa_kara
vilApa_kara	vilApa_kara
naRta_kara	naRta_kara
SAsana_kara	SAsana_kara
nirNaya_kara	nirNaya_kara
manana_kara	manana_kara
KUba_walASa_kara	KUba_walASa_kara
cAlU_kara	cAlU
jalxabAjZI_kara	jalxabAjZI
surakRiwa_karanA/bacA	surakRiwa_karanA/bacAnA
jalayAwrA_kara	jalayAwrA
pAra_kara	pAra
xukAna_para_kAma_karanevAlA	xukAna_para_kAma_karanevAlA
aBivAxana_kara	aBivAxana
SAnwa_kara	SAnwa
paviwra_kara	paviwra
maMjZUra_kara	maMjZUra
GisAI_karane_vAlA	GisAI_karane_vAlA
pariwqpwa_kara	pariwqpwa
kA_upahAsa_karanA/kI_ninxA_kara	kA_upahAsa_karanA/kI_ninxA
sanwuRta_kara	sanwuRta
pUrA_kara	pUrA
sanxeha_xUra_kara	sanxeha_xUra
saMwqpwa_kara	saMwqpwa
gIlA_kara_xe	gIlA_kara_xenA
cahala_kaxamI_kara	cahala_kaxamI
pasanxa_kara	pasanxa
garama_karanA/ubAla	garama_karanA/ubAlanA
kama_kara	kama
paryavekRaNa_kara	paryavekRaNa
xuKI_kara	xuKI
paryavekRaNa_kara	paryavekRaNa
wiwara-biwara_kara	wiwara-biwara
saPZAI_kara	saPZAI
suganXiwa_kara	suganXiwa
praSikRiwa_kara	praSikRiwa
upahAsa_kara	upahAsa
svaralipi_wEyAra_kara	svaralipi_wEyAra
se_GqNA_kara	se_GqNA
wiraskAra_kara	wiraskAra
saMGarRa_kara	saMGarRa
cIwkAra_kara	cIwkAra
karkaSaXvani_kara	karkaSaXvani
praxarSiwa_kara	praxarSiwa
mArjana_kara	mArjana
asaPala_kara	asaPala
BAga_jAnA/dubA	BAga_jAnA/dubAnA
banxa_kara	banxa
saBA	saBA
walASa_kara	walASa_kara
walASa_kara	walASa
BaviRya_kA_anumAna_kara	BaviRya_kA_anumAna
samarWana_karara	samarWana_kararanA
sWAnAnwariwa_kara	sWAnAnwariwa
pulisa	pulisa
srAviwa_kara	srAviwa
prApwa_kara_le	prApwa_kara_lenA
kI_rakRA_kara	kI_rakRA
surakRA_karmacArI	surakRA_karmacArI
SAnwa_kara	SAnwa_kara
kA_SIla_BaMga_kara	kA_SIla_BaMga
anuBava_kara	anuBava
kalpanA_kara	kalpanA
prabanXa_kara	prabanXa
vixA_kara	vixA
nirIkRaNa_kara	nirIkRaNa
pUrA_kara	pUrA
kI_sahAyawA_kara	kI_sahAyawA
koSiSa_kara	koSiSa
pqWaka_kara	pqWaka
giraPZwAra_kara	giraPZwAra
cayana_karake	cayana_karake
saMkewa_se_sUciwa_kara	saMkewa_se_sUciwa
kExa_kara	kExa
pExA_kara	pExA
nakala_kara_ke_hazsI_udZAne_kI_prakriyA	nakala_kara_ke_hazsI_udZAne_kI_prakriyA
anuBava_kara	anuBava
mehasUsa_kara	mehasUsa
jZabwa_kara	jZabwa
jZabwa_kara	jZabwa
sevA_kara	sevA
pUrA_kara	pUrA
ke_sAwa_vyavahAra_kara	ke_sAwa_vyavahAra
wAmIla_kara	wAmIla
saPZAI-XulAI_kara	saPZAI-XulAI
kI_ApUrwi_kara	kI_ApUrwi
lipibaxXa_kara	lipibaxXa
TIka_kara	TIka
niSciwa_kara	niSciwa
pravarwiwa_kara	pravarwiwa
1kampojZa_kara	1kampojZa
pICe_kara	pICe
samaJOwA_kara_le	samaJOwA_kara_lenA
nirNaya_kara	nirNaya
sInA/silAI_kara	sInA/silAI
Seda_kara	Seda_kara
AcCAxiwa_kara	AcCAxiwa
CAyiwa_karanA/gaharA	CAyiwa_karanA/gaharAnA
xurvyavahAra_kara	xurvyavahAra
xurbala_kara_xe	xurbala_kara_xenA
kA_aBinaya_kara	kA_aBinaya
sAJA_kara	sAJA
XarmAXikArI	XarmAXikArI
wIkRNa_kara	wIkRNa
tukadZe_tukadZe_kara_xenA_yA_ho_jA	tukadZe_tukadZe_kara_xenA_yA_ho_jAnA
naRta_karanA_yA_ho_jA	naRta_karanA_yA_ho_jAnA
Cinna_Binna_karanA_yA_ho_jA	Cinna_Binna_karanA_yA_ho_jAnA
AcCAxiwa_kara	AcCAxiwa
golAbArI_karanA/golI_barasA	golAbArI_karanA/golI_barasAnA
rakRA_karanA/bacA	rakRA_karanA/bacAnA
sWAnAnwariwa_kara	sWAnAnwariwa
powaBaMga_kara_	powaBaMga_kara_
GAyala_kara	GAyala
PZoto_lenA/PZilma_banAnA/calaciwriwa_kara	PZoto_lenA/PZilma_banAnA/calaciwriwa
bAjZAra_kara	bAjZAra
uTAIgIrI_kara	uTAIgIrI
laGupaWiwa_kara	laGupaWiwa
CotA_kara	CotA
sixXa_karanA/pramANiwa_kara	sixXa_karanA/pramANiwa
xiKAvA_kara	xiKAvA
SaMtiga_kara	SaMtiga
cupa_kara	cupa
banxa_kara	banxa
banxa_kara	banxa
banxa_kara	banxa
bahiRkqwa_kara	bahiRkqwa
cupa_kara	cupa
banxa_kara	banxa
vamana_kara	vamana
GqNA_uwpanna_kara	GqNA_uwpanna
GqNA_uwpanna_karawe_hue	GqNA_uwpanna_karawe_hue
lotapota_kara_xenevAlA	lotapota_kara_xenevAlA
kA_pakRa_lenA/kA_samarWana_kara	kA_pakRa_lenA/kA_samarWana
viRayAnwara_kara	viRayAnwara
haswAkRara_kara	haswAkRara
berojZagAra_vyakawi_ke_rUpa_meM_sUciwa_kara	berojZagAra_vyakawi_ke_rUpa_meM_sUciwa
kArya_keliye_saMJowA_kara	kArya_keliye_saMJowA
kArya_keliye_saMJowA_kara	kArya_keliye_saMJowA
saMkewa_karanA/siganala_xe	saMkewa_karanA/siganala_xenA
siganalamEna	siganalamEna
haswAkRara_karanevAlA_vyakwi	haswAkRara_karanevAlA_vyakwi
sUciwa_kara	sUciwa
KawwI/harI_PZasala_ikatTA_karane_kA_gadDA	KawwI/harI_PZasala_ikatTA_karane_kA_gadDA
mittI_yA_rewa_se_rAswA_banxa_karanA/rega_se_Bara	mittI_yA_rewa_se_rAswA_banxa_karanA/rega_se_BaranA
ArAma_kara	ArAma
hadZawAla	hadZawAla
uCala-kUxa_kara	uCala-kUxa
DIla_xenA/XImA_kara	DIla_xenA/XImA
burAI_kara	burAI
miWyApavAxa_kara	miWyApavAxa
wiraCA_kara	wiraCA
kadZI_AlocanA_kara	kadZI_AlocanA
Uropa_meM_xAsavqwwi_karanevAle_logoM_kI_BARA	Uropa_meM_xAsavqwwi_karanevAle_logoM_kI_BARA
AvAjZa_karake_hilA	AvAjZa_karake_hilAnA
kama_mehanawa_kara	kama_mehanawa
KAwe_yA_pIwe_samaya_AvAjZa_kara	KAwe_yA_pIwe_samaya_AvAjZa
sarvajFa_jEsA_praxarSana_karanevAlA	sarvajFa_jEsA_praxarSana_karanevAlA
parAjiwa_karanA/aMwa_kara	parAjiwa_karanA/aMwa
SISA_wodZa_kara_lUta	SISA_wodZa_kara_lUtanA
mElA_kara	mElA
baxanAma_kara	baxanAma
mAranA/prahAra_kara	mAranA/prahAra
XUmrapAna_kara	XUmrapAna
XUmrapAna_karane_vAlA_vyakwi	XUmrapAna_karane_vAlA_vyakwi
samawala_kara	samawala
saBya_warIke_se_bAwa_kara	saBya_warIke_se_bAwa
sapAta_kara	sapAta
SvAsa_avaruxXa_kara	SvAsa_avaruxXa_kara
waskara-vyApAra_kara	waskara-vyApAra
kAbU_karanA/aXikAra_jamA	kAbU_karanA/aXikAra_jamAnA
xaMSa_karanA/kAta	xaMSa_karanA/kAtanA
jalxI_karo	jalxI_karo
upahAsa_kara	upahAsa
sUz-sUz_karawA_jA	sUz-sUz_karawA_jAnA
TI_TI_kara	TI_TI
cumbana_kara	cumbana
pareSAna_karaxe	pareSAna_karaxenA
wAka_JAzka_kara	wAka_JAzka
warabawara_karaxe	warabawara_karaxenA
katuwA_kA_anuBava_kara	katuwA_kA_anuBava
halakA_karanA/kama_mahawwva_xe	halakA_karanA/kama_mahawwva_xenA
narama_kara	narama
mElA_kara	mElA
sAnwvanA_xenA/xuHKa_kama_kara_xe	sAnwvanA_xenA/xuHKa_kama_kara_xenA
xqDa_kara	xqDa
samAXAna_karane_yogya	samAXAna_karane_yogya
samAXAna	#samAXAna_karane_kA_warIkA samAXAna #samAXAna_karane_kA_warIkA
hala_kara	hala
SAnwa_kara	SAnwa
praSamana_kara	praSamana
jAxU-tonA_karane_vAlA	jAxU-tonA_karane_vAlA
anwaH_karaNa_meM_JAzka	anwaH_karaNa_meM_JAzkanA
uccAriwa_kara	uccAriwa
bacAnA/xayA_kara	bacAnA/xayA
sPuliMga-plaga/sPuliMga_pExA_karane_kA_yanwrara	sPuliMga-plaga/sPuliMga_pExA_karane_kA_yanwrara
bAwacIwa_kara	bAwacIwa
viSeRajFa_bananA/viSeRa_aXyayana_kara	viSeRajFa_bananA/viSeRa_aXyayana
BARaNIya_anxAjZa_meM_bAwa_kara	BARaNIya_anxAjZa_meM_bAwa
manwra-mugXa_karane_vAlA	manwra-mugXa_karane_vAlA
uccAraNa_karanA_yA_liKa	uccAraNa_karanA_yA_liKanA
Karca_kara	Karca
vamana_karanA/ugala	vamana_karanA/ugalanA
AwmAoM_se_samparka_karane_meM_viSvAsa	AwmAoM_se_samparka_karane_meM_viSvAsa
nArAjZa_kara	nArAjZa
ganxA_karanA/powa	ganxA_karanA/powanA
Karca_kara	Karca
bigAdZaxenA/KarAba_kara_xe	bigAdZaxenA/KarAba_kara_xenA
prAyojiwa_karanevAlA	prAyojiwa_karanevAlA
prAyojiwa_kara	prAyojiwa
spOYta_karanevAlA	spOYta_karanevAlA
SrqMgAra_kara	SrqMgAra
TukarAnA/wiraskAra_kara	TukarAnA/wiraskAra
WodZI_xera_waka_badZI_wejZI_se_kAma_kara	WodZI_xera_waka_badZI_wejZI_se_kAma
Baka-Baka_kara	Baka-Baka
uwwejiwa_ho_kara_bola	uwwejiwa_ho_kara_bolanA
jAsUsI_kara	jAsUsI
barAbara_kara	barAbara
wiraskAra_kara	wiraskAra
XakiyA_kara_Gusa	XakiyA_kara_GusanA
cUz-cUz_karanA/kikiyA	cUz-cUz_karanA/kikiyAnA
Paca-Paca_kara	Paca-Paca
Paca-Paca_karane_vAlA	Paca-Paca_karane_vAlA
prahAra_kara	prahAra
sWira_kara	sWira
XabbevAlA_kara	XabbevAlA
xAvA_kara	xAvA
kArya_ko_bAXiwa_kara	kArya_ko_bAXiwa
hakalAnA/ruka_ruka_kara_bola	hakalAnA/ruka_ruka_kara_bolanA
praBAviwa_kara	praBAviwa
binA_soce_samaJe_kArya_kara	binA_soce_samaJe_kArya
KadZA_kara	KadZA
mAnakIkqwa_kara	mAnakIkqwa
stepala_kara	stepala
wArAMkiwa_kara	wArAMkiwa
SurU_kara	SurU
SurU_kara	SurU
yAwrA_SurU_kara	yAwrA_SurU
SurU_kara	SurU
xubArA_se_SurU_kara	xubArA_se_SurU
SurU_karane_vAlA	SurU_karane_vAlA
SurU_karane_vAlA_sWAna	SurU_karane_vAlA_sWAna
SurU_karane_kA_sWAna	SurU_karane_kA_sWAna
BUKa_kI_pUrwi_na_karane_lAyaka_Bojana	BUKa_kI_pUrwi_na_karane_lAyaka_Bojana
saMciwa_kara	saMciwa
aBivyakwa_karane_yogya	aBivyakwa_karane_yogya
aBivyakwa_kara	aBivyakwa_kara
aBivyakwa_kara	aBivyakwa
wEnAwa_kara	wEnAwa_kara
Cexa_kara_xe	Cexa_kara_xenA
hAWa_pakadZakara_koI_kArya_karane_se_pICe_hatA	hAWa_pakadZakara_koI_kArya_karane_se_pICe_hatAnA
corI_kara	corI
mInAra_marammawa_karanevAlA	mInAra_marammawa_karanevAlA
niRkItiwa_kara	niRkItiwa
baraxASwa_kara	baraxASwa
saWApiwa_kara	saWApiwa
uwwejiwa_kara	uwwejiwa
kaMjUsI_kara	kaMjUsI
kAma_karane_kA_samaya	kAma_karane_kA_samaya
sOxA_waya_kara	sOxA_waya
jAnavaroM_kI_xeKa-reKa_karanevAlA	jAnavaroM_kI_xeKa-reKa_karanevAlA
paMpa	paMpa
xIvAra_KadZI_kara	xIvAra_KadZI_kara
anwa_kara	anwa
jAnakArI_kA_saMgraha_kara	jAnakArI_kA_saMgraha
saMciwa_kara	saMciwa
hamalA_kara	hamalA
Cipakara_yAwrA_karanevAlA	Cipakara_yAwrA_karanevAlA
para_golAbArI_kara	para_golAbArI
sIXA_kara	sIXA
pICA_kara	pICA
vyavahAra_ko_niyanwriwa_karanevAlA_niyama	vyavahAra_ko_niyanwriwa_karanevAlA_niyama
KojZa_kara	KojZa
hadZawAla_karanevAlA	hadZawAla_karanevAlA
XyAna_AkarRiwa_karanevAlI	XyAna_AkarRiwa_karanevAlI
naMgA_kara	naMgA
ke_lie_prayAsa_kara	ke_lie_prayAsa
kA_mukAbalA_kara	kA_mukAbalA
sEra_karanevalA	sEra_karanevalA
racanA_kara	racanA
saMgrAma_kara	saMgrAma
prayawna_kara	prayawna
gacakArI_kara	gacakArI
aXyayana_kara	aXyayana
BUla_kara	BUla
Auta_kara_xe	Auta_kara_xenA
acewa_kara	acewa
jadZa_kara_xe	jadZa_kara_xenA
vismiwa_kara_xe	vismiwa_kara_xenA
praviBAjiwa_kara	praviBAjiwa
saMkewa_xvArA_sUciwa_kara	saMkewa_xvArA_sUciwa
aXIna_kara	aXIna
sixXa_kara	sixXa
sammiliwa_kara	sammiliwa
kakRAnwariwa_kara	kakRAnwariwa
xuRpreriwa_kara	xuRpreriwa
aMSaxAna_kara	aMSaxAna
sixXa_kara	sixXa
samAviRta_kara	samAviRta
sahAyawA_karanA_	sahAyawA_karanA_
kisI_para_mukaxamA_kAyama_kara	kisI_para_mukaxamA_kAyama
kaluRiwa_kara	kaluRiwa
alaga_kara	alaga
aXyAropiwa_kara	aXyAropiwa
paryavekRaNa_kara	paryavekRaNa
paryavekRaNA_kara	paryavekRaNA
sWAna_yA_paxa_grahaNa_kara	sWAna_yA_paxa_grahaNa
paripUrNa_kara	paripUrNa
prArWanA_kara	prArWanA
saplAI_kara	saplAI
BaraNa_poRaNa_kara	BaraNa_poRaNa
xabAnA/xamana_kara	xabAnA/xamana
vijaya_pAnA_yA_pAra_kara	vijaya_pAnA_yA_pAra
AScaryacakiwa_kara	AScaryacakiwa
AwmasamarpaNa_kara	AwmasamarpaNa
awirikwa_kara	awirikwa_kara
jAzcanA/nirIkRaNa_kara	jAzcanA/nirIkRaNa
sarvekRaNa_kara	sarvekRaNa
sanxeha_kara	sanxeha
nilambiwa_kara	nilambiwa
sWagiwa_kara	sWagiwa
nirvAha_kara	nirvAha
AzKa_mUzxakara_viSvAsa_kara	AzKa_mUzxakara_viSvAsa
samApwa_kara	samApwa
axala-baxala_kara	axala-baxala
praBAviwa_kara	praBAviwa
saPZAI_kara	saPZAI
saPAI_kara	saPAI
kaTina_pariSrama_kara	kaTina_pariSrama
prawIka_xvArA_praswuwa_kara	prawIka_xvArA_praswuwa
saMSleRaNa_kara	saMSleRaNa
picakArI_se_sAPZa_kara	picakArI_se_sAPZa
suvyavasWiwa_kara	suvyavasWiwa
praswAviwa_kara	praswAviwa
Bojana_karawe_samaya_sAmAjika_vyavahAra	Bojana_karawe_samaya_sAmAjika_vyavahAra
varjiwa_karma	varjiwa_karma
sAraNIbaxXa_kara	sAraNIbaxXa
xURiwa_kara	xURiwa
giraPwAra_kara	giraPwAra
svIkAra_kara_le	svIkAra_kara_lenA
samAhiwa_kara	samAhiwa
bAwacIwa_kara	bAwacIwa
vaSa_kara	vaSa
haswakRepa_kara	haswakRepa
meM_haswakRepa_kara	meM_haswakRepa
AvAja_rekArda_karane_kI_pattI	AvAja_rekArda_karane_kI_pattI
aBileKana_kara	aBileKana
tepa_rikOYrdara	tepa_rikOYrdara
kalaMkiwa_kara	kalaMkiwa_kara
niyawa_kAma_niyukwa_kara	niyawa_kAma_niyukwa
kasa_kara_wanA_huA	kasa_kara_wanA_huA
AgA_pICA_kara	AgA_pICA
telIPona_kara	telIPona_kara
telIprAmpatara	telIprAmpatara
sUciwa_kara	sUciwa
kama_kara	kama
nirNaya_karane_meM_xera_kara	nirNaya_karane_meM_xera
xeKaBAla_kara	xeKaBAla
peSa_kara	peSa
samApwa_kara	samApwa
AwaMkiwa_kara	AwaMkiwa
AwaMkiwa_kara	AwaMkiwa
jAzca_kara	jAzca
vAyuyAna_ko_calAkara_parIkRA_karane_vAlA_cAlaka	vAyuyAna_ko_calAkara_parIkRA_karane_vAlA_cAlaka
parIkRaNa_kara	parIkRaNa
sixXAnwa_sWApiwa_kara	sixXAnwa_sWApiwa_kara
lo-xeKo	lo-xeKo
gADZA_kara	gADZA
pawalA_yA_kama_kara	pawalA_yA_kama
kalpanA_kara	kalpanA
manana_kara	manana
vicAra_karane_kI_kriyA	vicAra_karane_kI_kriyA
paravicAra_karane_kA_viRaya	paravicAra_karane_kA_viRaya
parAjiwa_kara	parAjiwa
romAMciwa_kara	romAMciwa
BIdZa_kara	BIdZa
banxa_kara	banxa
XamAkA_kara	XamAkA
aMgUTA_lagAkara_palata	aMgUTA_lagAkara_palatanA
azgUTe_se_iSArA_kara	azgUTe_se_iSArA
gadZagadZAhata_kara	gadZagadZAhata
GadZI_ke_samAna_tika_tika_kara	GadZI_ke_samAna_tika_tika
tika_kara	tika_kara
KidakI_se_kAgaja_kI_pattI_dAlakara_viKyAwa_puruRa_yA_uwsava_kA_svAgawa_kara	KidakI_se_kAgaja_kI_pattI_dAlakara_viKyAwa_puruRa_yA_uwsava_kA_svAgawa
vyavasWiwa_kara	vyavasWiwa_kara
TIka_TAka_kara	TIka_TAka
samApwa_kara	samApwa
baMXeja_kI_raMgAI_kara	baMXeja_kI_raMgAI
samaya_kI_gaNanA_karane_kI_SElI	samaya_kI_gaNanA_karane_kI_SElI
dibbe_meM_banXa_kara	dibbe_meM_banXa
soKwAxAna	soKwAxAna
kaccA_kAma_kara	kaccA_kAma
weja_CotI_AvAja_kara	weja_CotI_AvAja
AsAnI_se_jAne_xe	AsAnI_se_jAne_xenA
sAvaXAna_kara	sAvaXAna
paMjoM_kara_bala_cala	paMjoM_kara_bala_calanA
kaRta_kara	kaRta
se_KilavAdZa_kara	se_KilavAdZa
tAipa_kara	tAipa_kara
uwwejiwa_kara	uwwejiwa
gapa_Sapa_kara	gapa_Sapa
se_milA_kara	se_milA_kara
AxeSa_kA_pAlana_kara	AxeSa_kA_pAlana
pariSrama_kara	pariSrama_kara
sahana_kara	sahana
xAzwa_sAPa_karane_kA_bruSa	xAzwa_sAPa_karane_kA_bruSa
sparSa_kara	sparSa_kara
asara_kara	asara
TIka_kara	TIka
kadZA_kara	kadZA_kara
xOrA_kara	xOrA
aswavyaswa_kara_xe	aswavyaswa_kara_xenA
xalAlI_kara	xalAlI_kara
vyApAra_kara	vyApAra
vaswu_vinimaya_kara	vaswu_vinimaya
ninxA_kara	ninxA
anuciwa_vyApAra_karane_vAlA	anuciwa_vyApAra_karane_vAlA
Waka_kara_cala	Waka_kara_calanA
trena_meM_kAma_karane_vAlA_karmI	trena_meM_kAma_karane_vAlA_karmI
praSikRiwa_kara	praSikRiwa
aByAsa_kara	aByAsa
anuvarXana_kara	anuvarXana
Xaba-Xaba_karawe_hue_cala	Xaba-Xaba_karawe_hue_calanA
paxa_yAwrA_kara	paxa_yAwrA
wiraskAra_kara	wiraskAra
SAnwa_kara	SAnwa
kArabAra_kara	kArabAra
prawilipi_kara	prawilipi
anya_vAxya_ke_lie_wEyAra_kara	anya_vAxya_ke_lie_wEyAra
anwariwa_kara	anwariwa
sWAnAnwariwa_kara	sWAnAnwariwa
anuciwriwa_kara	anuciwriwa
rUpAnwariwa_kara	rUpAnwariwa
awikramaNa_kara	awikramaNa
anuvAxa_kara	anuvAxa
lipyanwaraNa_kara	lipyanwaraNa
prasAriwa_kara	prasAriwa
prawiropiwa_kara	prawiropiwa
vahana_kara	vahana
BinnaliMga_veSa_XAraNa_karane_vAlA	BinnaliMga_veSa_XAraNa_karane_vAlA
kUdA_karakata	kUdA_karakata
yAwrA_kara	yAwrA
nArAja_kara	nArAja
vyavahAra_kara	vyavahAra
vivecana_kara	vivecana
cikiwsA_kara	cikiwsA
saMsAXiwa_kara	saMsAXiwa
kA_Karca_kara	kA_Karca
wigunA_kara	wigunA
lambI_yAwrA_kara	lambI_yAwrA
awikramaNa_kara	awikramaNa
aparAXa_kara	aparAXa
cIna_ke_gupwa_saMGatana_jo_anuciwa_kAma_karaweM_hEM	cIna_ke_gupwa_saMGatana_jo_anuciwa_kAma_karaweM_hEM
bEtarI_cArja_karanevAlA_vixyuwa_yanwra	bEtarI_cArja_karanevAlA_vixyuwa_yanwra
yanwra_ko_cAlU_karane_kA_purjA	yanwra_ko_cAlU_karane_kA_purjA
preriwa_kara	preriwa
eka_karoda_Karaba	eka_karoda_Karaba
kAta_CAzta_kara	kAta_CAzta
ulaJa_kara_gira	ulaJa_kara_giranA
galawI_kara	galawI
yAwrI	yAwrI
paSuoM_kI_Azwa	paSuoM_kI_Azwa
wigunA_kara	wigunA
newA_ke_rUpa_meM_kAma_karane_vAle_wIna_jana	newA_ke_rUpa_meM_kAma_karane_vAle_wIna_jana
	
sUcanA_yA_saPAI_praxarSiwa_kara	sUcanA_yA_saPAI_praxarSiwa
pareSAna_kara	pareSAna
namrawApUrvaka_nivexana_kara	namrawApUrvaka_nivexana
xoRa_xUra_karanevAlA	xoRa_xUra_karanevAlA
xala	xala
sOxAgarI_kara	sOxAgarI
sirA_kAtakara_CotA_kara	sirA_kAtakara_CotA
viSvAsa_karane_vAlA	viSvAsa_karane_vAlA
BarosA_kara	BarosA
ASA_kara	ASA
koSiSa_kara	koSiSa
kAnUnI_jAzca_kara	kAnUnI_jAzca
asvIkAra_kara	asvIkAra
vikqwa_kara	vikqwa
tAIpa_kara	tAIpa
tAipa_karane_vAlA	tAipa_karane_vAlA
AraMBa_karanevAlA	AraMBa_karanevAlA
asaMwuliwa_kara_xe	asaMwuliwa_kara_xenA
lagAma_hatA/CodZa_xe/svawaMwra_kara	lagAma_hatA/CodZa_xe/svawaMwra_kara
sikadZI_se_mukwa_kara	sikadZI_se_mukwa_kara
alaga_karake_kAta	alaga_karake_kAtanA
parxA_xUra_kara	parxA_xUra_kara
prakASa_kara	prakASa_kara
sIXA_kara	sIXA
kama_AMkalana_kara	kama_AMkalana
kama_uxBAsiwa_kara	kama_uxBAsiwa
anuBava_kara	anuBava
aXInasWa_karmacArI	aXInasWa_karmacArI
reKAMkiwa_kara	reKAMkiwa
hAWa_meM_lene_vAlA/prayawna_karane_vAlA	hAWa_meM_lene_vAlA/prayawna_karane_vAlA
avamUlyana_kara	avamUlyana
ayogya_kara	ayogya_kara
prakata_yA_prakASa_kara	prakata_yA_prakASa
varNana_kara	varNana
saMyukwa_kara	saMyukwa
pravarwiwa_kara	pravarwiwa
boJa_uwAra/halakA_kara	boJa_uwAra/halakA_kara
KAlI_kara	KAlI
DIlA_kara	DIlA
pOruRahIna_kara	pOruRahIna
hawowsAha_kara	hawowsAha
hawowsAha_kara	hawowsAha
hatA/asWira_kara/gadZabadZa_kara	hatA/asWira_kara/gadZabadZa_kara
asWira_kara/caMcala_kara	asWira_kara/caMcala_kara
BarwsanA_kara	BarwsanA
ulatA_kara	ulatA
unnawi_kara	unnawi
UzcA_kara/uTA	UzcA_kara/uTA
nirmUla_kara	nirmUla_kara
peSAba_kara	peSAba_kara
upayoga_kara	upayoga_kara
prayoga_kara	prayoga_kara
praveSaka/BeMta_karAne_vAlA	praveSaka/BeMta_karAne_vAlA
praveSa_karAnA/BeMta_karA	praveSa_karAnA/BeMta_karA
niScaya_na_kara_pA	niScaya_na_kara_pAnA
niScaya_na_kara_pAne_kI_sWiwi	niScaya_na_kara_pAne_kI_sWiwi
Axara_kara	Axara
kisI_vaswu_ke_uwpAxana_para_lagAe_jAne_vAlA_kara	kisI_vaswu_ke_uwpAxana_para_lagAe_jAne_vAlA_kara
rAkRasa	rAkRasa
Anxolana_kA_newqwva_karane_vAlA	Anxolana_kA_newqwva_karane_vAlA
GUMGata_kara	GUMGata
Axara_kara	Axara
havA_kara	havA
sAhasa_kara	sAhasa
sawyawA_kI_jAzca_kara	sawyawA_kI_jAzca
aXikAra_praxAna_kara	aXikAra_praxAna
BalI_prakAra_jAzca_kara	BalI_prakAra_jAzca
kAnUna_kA_masUxA_asvIkqwa_kara	kAnUna_kA_masUxA_asvIkqwa
gussA_kara	gussA_kara
sparXA_kara	sparXA
nirIkRaNa_karanA[Gara_yA_jAyaxAxa	nirIkRaNa_karanA[Gara_yA_jAyaxAxa
apavAxa_kara	apavAxa
mahawvapUrNa_samaya	mahawvapUrNa_samaya
BeMta_karanevAlA	BeMta_karanevAlA
kalpanA_kara	kalpanA
xURiwa_kara	xURiwa
uccAraNa_kara	uccAraNa
vicAra_vyakwa_kara	vicAra_vyakwa
avEXAnika_GoRiwa_kara	avEXAnika_GoRiwa
pestrI	pestrI
apanI_sevAez_arpiwa_kara	apanI_sevAez_arpiwa_kara
svecCA_se_kAma_kara	svecCA_se_kAma
kE_kara	kE_kara
kqpApUrvaka_praxAna_kara	kqpApUrvaka_praxAna
valkaniwa_karanA2	valkaniwa_karanA2
sparXA_karawe_hue	sparXA_karawe_hue
kaTinAI_pUrvaka_pExala_pAra_karanA{pAnI,kIcadZa,rewa	kaTinAI_pUrvaka_pExala_pAra_karanA{pAnI,kIcadZa,rewa
pExala_pAra_kara	pExala_pAra
tikiyA_se_baMxa_kara	tikiyA_se_baMxa
kirAyA_kara	kirAyA
vilApa_kara	vilApa
prawIkRA_kara	prawIkRA
cihna_kara	cihna
rakRA_kara	rakRA
garma_kara	garma
garama_karane_kA_sAXana	garama_karane_kA_sAXana
naRta_kara	naRta
raKavAlI_karane_vAlA_kuwwA	raKavAlI_karane_vAlA_kuwwA
nirbala_kara	nirbala
samApwa_kara	samApwa
XAraNa_karane_yogya	XAraNa_karane_yogya
pAra_kara	pAra
mOsama_pUrvAnumAna_karwA	mOsama_pUrvAnumAna_karwA
eka_hI_kaWAsUwra_meM_graWiwa_kara	eka_hI_kaWAsUwra_meM_graWiwa
byAha_kara	byAha
svAgawa_kara	svAgawa
gIlA_kara	gIlA
jahAja_jisa_para_se_vhela_kA_SikAra_karawe_hEM	jahAja_jisa_para_se_vhela_kA_SikAra_karawe_hEM
uwwejiwa_kara	uwwejiwa
rUM_rUM_kara	rUM_rUM
Sabxa_karawe_hue_GUma	Sabxa_karawe_hue_GUmanA
wErane_kA_sWAna	wErane_kA_sWAna
kAnA_PUsI_kara	kAnA_PUsI
burAI_karawe_cale_jA	burAI_karawe_cale_jAnA
saPexa_kara	saPexa
saPexI_kara	saPexI
viXavA_kara	viXavA
xarxa_aBivyakwa_kara	xarxa_aBivyakwa
SuBakAmanA_kara	SuBakAmanA
sAmanA_kara	sAmanA
nahIM_karUzgA	nahIM_karUzgA
praNaya_nivexana_kara	praNaya_nivexana
vivAha_hewu_prArWanA_kara	vivAha_hewu_prArWanA
SabxoM_meM_prakata_kara	SabxoM_meM_prakata
SabxoM_meM_prakata_kara	SabxoM_meM_prakata
kAma_kara	kAma
vyakwi_jise_saxA_kAma_karane_kI_Axawa_ho	vyakwi_jise_saxA_kAma_karane_kI_Axawa_ho
kAma_karane_kA_meja	kAma_karane_kA_meja
kAma_karane_kA_PattA	kAma_karane_kA_PattA
pareSAna_kara	pareSAna
sammAna_kara	sammAna
GAyala_kara	GAyala
nASa_kara	nASa
muSkila_se_prApwa_kara	muSkila_se_prApwa
kuSwI_kara	kuSwI
nyAyika_AxeSa	nyAyika_AxeSa
racanA_kara	racanA
anyAya_kara	anyAya
avEXa_kAma_karanevAlA	avEXa_kAma_karanevAlA
nOkA_sEra_karanA/ukwa_nOkA_meM_jAnA_yA_sEra_kara	nOkA_sEra_karanA/ukwa_nOkA_meM_jAnA_yA_sEra
bakavAsa_kara	bakavAsa
icCA_kara	icCA
pIlA_kara	pIlA
behoSa_kara	behoSa
naRta_kara	naRta
jZebrA_krAsiMga	jZebrA_krAsiMga
XyAna_kenxriwa_kara	XyAna_kenxriwa
niyawa_samaya	niyawa_samaya
jZipa	jZipa
jZipa_KolanA_yA_baMxa_kara	jZipa_KolanA_yA_baMxa
kRewroM_meM_viBAjiwa_kara	kRewroM_meM_viBAjiwa
kama_ho	kama
garBapAwa_ho	garBapAwa
bahuwAyAwa_se_ho	bahuwAyAwa_se
bahuwa_ho_gayA	bahuwa_ho_gayA
ParAra_ho	ParAra
anupasWiwa_ho	anupasWiwa
xaSAnukUliwa_ho	xaSAnukUliwa_ho
sAWa_ho	sAWa_ho
kuCa_hone_kI_ASaMkA	kuCa_hone_kI_ASaMkA
niSciwa_mAwrA_meM_ho	niSciwa_mAwrA_meM
ikaTTA_ho	ikaTTA
aByaswa_ho	aByaswa
sahamawa_ho	sahamawa
sahamawa_howe_hue	sahamawa_howe_hue
saMyukwa_ho	saMyukwa_ho
wraswa_ho	wraswa_ho
badZA_ho_jA	badZA_ho_jAnA
purAnA_ho	purAnA
awyanwa_pIdZiwa_ho	awyanwa_pIdZiwa
sahamawa_ho	sahamawa
vAyusEnikajo_aPasara_paxa_se_nIce_ho	vAyusEnikajo_aPasara_paxa_se_nIce_ho
jisameM_bahuwa_sAre_praKyAwa_aBinewA/aBinewriyAz_ho	jisameM_bahuwa_sAre_praKyAwa_aBinewA/aBinewriyAz_ho
awi_naPZarawa_ho	awi_naPZarawa
jisameM_xUsarA_uccawama_svara_ho	jisameM_xUsarA_uccawama_svara_ho
waWAswu/EsA_hI_ho	waWAswu/EsA_hI_ho
ke_barAbara_ho	ke_barAbara
golAkAra_imArawa_jisameM_xarSakoM_ke_bETane_kI_vyavasWA_ho	golAkAra_imArawa_jisameM_xarSakoM_ke_bETane_kI_vyavasWA_ho
prakata_ho	prakata
prakASiwa_ho	prakASiwa
upasWiwa_ho	upasWiwa
lAgU_ho	lAgU
vqxXi_ho	vqxXi
svIkqwa_hone_para	svIkqwa_hone_para
KadZA_ho	KadZA
haWiyAroM_kI_hodZa	haWiyAroM_kI_hodZa
mOjUxa_ho	mOjUxa
bOCAra_ho	bOCAra_ho
ekawriwa_ho	ekawriwa
judA_ho	judA
niSciwa_ho	niSciwa
aXikqwa_ho	aXikqwa
jAgarUka_ho	jAgarUka
jisake_pAsa_koI_AXikArika_paxa_na_ho_EsA_sAMsaxa	jisake_pAsa_koI_AXikArika_paxa_na_ho_EsA_sAMsaxa
pICe_honA	pICe_honA
ultI_prawikriyA_ho	ultI_prawikriyA
prakASiwa_ho_rahI_puswakoM_kI_sUcI	prakASiwa_ho_rahI_puswakoM_kI_sUcI
pawiwa_ho	pawiwa
gaMjApana_ho	gaMjApana
eka_prakAra_kA_pedZa_jisake_hare_pawwe_Ora_jAmunI_Pala_ho	eka_prakAra_kA_pedZa_jisake_hare_pawwe_Ora_jAmunI_Pala_ho
havA_na_hone_ke_kAraNa_hilane_meM_asamarWa	havA_na_hone_ke_kAraNa_hilane_meM_asamarWa
PabanA/uciwa_ho	PabanA/uciwa
janaka_ho	janaka
prAramBa_ho	prAramBa
upayukwa_ho	upayukwa
saxasya_ho	saxasya
sAvaXAna_ho	sAvaXAna
PUlanA/KilanA/samqxXa_honA/Pala	PUlanA/KilanA/samqxXa_honA/PalanA
acAnaka_Ora_jora_se_SurU_ho_jA	acAnaka_Ora_jora_se_SurU_ho_jAnA
kuprabanXase_naRta_ho_jA	kuprabanXase_naRta_ho_jAnA
se_lagA_huA_ho	se_lagA_huA
jo_niSciwa_rUpa_se_prAsaMgika_na_ho	jo_niSciwa_rUpa_se_prAsaMgika_na_ho
viBAjiwa_ho	viBAjiwa
BaMga_honevAlI_mOja	BaMga_honevAlI_mOja
sIXA_KadZA_ho	sIXA_KadZA
gorI_swrI_jisake_kAle_bAla_ho	gorI_swrI_jisake_kAle_bAla_ho
pallaviwa_ho	pallaviwa
pallaviwa_howI_huI	pallaviwa_howI_huI
ekawra_ho	ekawra
ekAeka_prakata_ho_jA	ekAeka_prakata_ho_jAnA
jarUrawa_ho	jarUrawa
SarwoM_ke_aXIna_ho	SarwoM_ke_aXIna
garBavawI_ho	garBavawI
samarWana_ho	samarWana
uwwejiwa_ho	uwwejiwa
kAraNa_honA/uwpanna_kara	kAraNa_honA/uwpanna
SawavarRIya/sO_barasa_meM_eka_bAra_honevAlA	SawavarRIya/sO_barasa_meM_eka_bAra_honevAlA
saMyogavaSa_ho_jA	saMyogavaSa_ho_jAnA
ajIba_guNa_ho	ajIba_guNa
TaNdA_ho_jA	TaNdA_ho_jAnA
SvAsAvaroXa_ho	SvAsAvaroXa
avaruxXa_ho	avaruxXa
kA_pAwra_ho	kA_pAwra
nukasAna_kA_kAraNa_ho	nukasAna_kA_kAraNa
sAWa_sAWa_ho	sAWa_sAWa
bemela_ho	bemela
eka_hI_samaya_para_ho	eka_hI_samaya_para
svacCa_ho	svacCa
DakA_huA_ho	DakA_huA
banxa_ho	banxa
samApwa_ho	samApwa
CotA_ho	CotA
Amane_sAmane_ho	Amane_sAmane
kisI_kArya_meM_magna_ho	kisI_kArya_meM_magna
WakkA_ho	WakkA
acAnaka_bAriSa_ho	acAnaka_bAriSa
BIdZa_lagAnA/eka_sAWa_BArI_saMKyA_meM_eka_sWAna_para_ho	BIdZa_lagAnA/eka_sAWa_BArI_saMKyA_meM_eka_sWAna_para
eka_hI_jadZa_se_uwpanna_ho	eka_hI_jadZa_se_uwpanna
pUrNa_jAnakAra_ho	pUrNa_jAnakAra
saMsakwa_ho	saMsakwa
anurUpa_ho	anurUpa
samaJane_meM_sarala_ho	samaJane_meM_sarala
eka_jEsA_ho	eka_jEsA
pasInA_pasInA_ho	pasInA_pasInA
pawana_ho	pawana
ekawra_ho	ekawra
upalabXa_ho	upalabXa
pIdZiwa_ho	pIdZiwa
AnA/SAmila_ho	AnA/SAmila
saPala_evaM_praBAvaSAlI_ho	saPala_evaM_praBAvaSAlI
kisI_GatanA_ke_hone_kA_samaya_najZaxIka_A	kisI_GatanA_ke_hone_kA_samaya_najZaxIka_AnA
AramBa_ho	AramBa
garBa_se_ho	garBa_se
sahamawa_ho	sahamawa
samakAlIna/eka_sAWa_hone_vAlA	samakAlIna/eka_sAWa_hone_vAlA
saGana_honA/jama_jA	saGana_honA/jama_jAnA
oCA_kAma_karane_ke_lie_rAjZI_ho	oCA_kAma_karane_ke_lie_rAjZI_ho
saMkulana/BarA_huA_ho	saMkulana/BarA_huA
ekawra_ho	ekawra
yukwa_ho	yukwa_ho
Tosa_honA/kara	Tosa_honA/karanA
_yukwa_ho	_yukwa_ho
se_yukwa_ho	se_yukwa
pUrNawaH_viBAjiwa_ho	pUrNawaH_viBAjiwa
prawisparXA_meM_ho	prawisparXA_meM
viparIwa_ho	viparIwa
ekawra_honA/batura	ekawra_honA/baturanA
xqDZa_mawa_ho	xqDZa_mawa
TaNdA_honA/SAMwa_ho	TaNdA_honA/SAMwa
paraspara_sambanXa_ho	paraspara_sambanXa
anurupa_ho	anurupa
pawra_vyavahAra_ho	pawra_vyavahAra
jo_samawulya_ho	jo_samawulya_ho
BraRta_ho_jA	BraRta_ho_jAnA
kamarA_jisameM_pariRaxa_kI_bETaka_howI_hEM	kamarA_jisameM_pariRaxa_kI_bETaka_howI_hEM
paryApwa_ho	paryApwa
visPota_ke_PalasvarUpa_hone_vAlA_gadDA	visPota_ke_PalasvarUpa_hone_vAlA_gadDA
reMgane_vAlI_cIjoM_se_BarA_ho	reMgane_vAlI_cIjoM_se_BarA
ciMgata	ciMgata
JakI_ho_jA	JakI_ho_jAnA
XIre-XIre_AsAnI_se_jFAwa_na_ho	XIre-XIre_AsAnI_se_jFAwa_na
UzcA_howe_jAnA/pragawi_karawe_raha	UzcA_howe_jAnA/pragawi_karawe_rahanA
lAla_ho_jA	lAla_ho_jAnA
Kewa_ke_bIca_me_gola_GerA_jahAz_jamIna_capatI_ho_jAwI_hE	Kewa_ke_bIca_me_gola_GerA_jahAz_jamIna_capatI_ho_jAwI_hE
acAnaka_uwpanna_ho	acAnaka_uwpanna
SiKara_para_ho	SiKara_para
cUra_cUra_ho	cUra_cUra
viGatiwa_ho	viGatiwa
Xvaswa_ho	Xvaswa
vakra_ho	vakra
bigadZa_jAnA/naRta_ho_jA	bigadZa_jAnA/naRta_ho_jAnA
kAlA_ho_jA	kAlA_ho_jA
azXerA_ho	azXerA_ho
hawowsAhiwa_ho	hawowsAhiwa
saberA_ho	saberA
AraMBa_honA/uxBava_ho	AraMBa_honA/uxBava
jisa_samaya_sunasAna_ho	jisa_samaya_sunasAna_ho
sadZanA/bigadZanA/GatanA/muraJAnA/nASa_ho	sadZanA/bigadZanA/GatanA/muraJAnA/nASa
kRINa_ho_jA	kRINa_ho_jAnA
baMxa_ho_jA	baMxa_ho_jAnA
apaGatiwa_ho_jA	apaGatiwa_ho_jAnA
Ora_gaharA_ho_jA	Ora_gaharA_ho_jAnA
eka_rAjanEwika_pArtI_ko_wyAga_kara_xUsarI_meM_SAmila_ho	eka_rAjanEwika_pArtI_ko_wyAga_kara_xUsarI_meM_SAmila
sahaja_meM_rakRA_hone_yogya	sahaja_meM_rakRA_hone_yogya
nirXAriwa_ho	nirXAriwa
kama_ho	kama
vikqwa_ho	vikqwa
kRaya_ho	kRaya
kRaya_ho	kRaya
naRta_ho	naRta
naRta_hone_yogya	naRta_hone_yogya
SarIra_meM_pAnI_kI_kamI_ho	SarIra_meM_pAnI_kI_kamI
KuSa_ho	KuSa
KuSI_se_pAgala_ho_jA	KuSI_se_pAgala_ho_jAnA
gOrava_kama_ho	gOrava_kama
ASriwa_ho	ASriwa
BraRta_ho	BraRta
uwpanna_ho	uwpanna
kA_vaMSaja_ho	kA_vaMSaja
vIrAna_ho_jA	vIrAna_ho_jAnA
yogya_ho	yogya
nirASa_ho	nirASa
kalaMkiwa_ho	kalaMkiwa
mArga_se_alaga_ho	mArga_se_alaga
Binna_ho	Binna
XuMXalA_honA/kara	XuMXalA_honA/karanA
kama_ho	kama
asahamawa_ho	asahamawa
axqSya_ho	axqSya
asanwuRta_ho	asanwuRta_ho
moha_xUra_ho	moha_xUra
mawaBexa_ho	mawaBexa
alaga_karanA_yA_ho_jA	alaga_karanA_yA_ho_jAnA
koI_vyavasWA_kA_Kawma_ho	koI_vyavasWA_kA_Kawma
sammawa_honA/eka_mawa_ho	sammawa_honA/eka_mawa
alaga_alaga_ho	alaga_alaga_ho
miwrawA_wodZanA/Binnamawa_ho	miwrawA_wodZanA/Binnamawa
xoharA_ho_jA	xoharA_ho_jAnA
1nirASa_ho_jA	1nirASa_ho_jAnA
drOY	drOY
bUMxA_bAMxI_ho	bUMxA_bAMxI
hawapraBa_ho	hawapraBa
kRINa_ho_jA	kRINa_ho_jAnA
mUlya_kama_ho	mUlya_kama
kama_ho	kama
prawiXvaniwa_ho	prawiXvaniwa
ekleyara	ekleyara
cAlU_ho	cAlU
balapUrvaka_bAhara_ho	balapUrvaka_bAhara_ho
bIwanA/vyawIwa_honA/gujara_jAnA/calA_jA	bIwanA/vyawIwa_honA/gujara_jAnA/calA_jAnA
bijalI_se_mqwyu_ho	bijalI_se_mqwyu
svara_kA_lopa_ho	svara_kA_lopa
nikalanA/uwpanna_ho	nikalanA/uwpanna
nikalanA/uBaranA/prakata_ho	nikalanA/uBaranA/prakata
BAvuka_ho	BAvuka_ho
samAnuBUwa_ho	samAnuBUwa
sAmanA_ho	sAmanA_ho
pExA_ho	pExA
wanmaya_ho	wanmaya
sAkAra_rUpa_ho	sAkAra_rUpa
kRaya_ho_jAnA/kata_jA	kRaya_ho_jAnA/kata_jAnA
BApa_ho_jA	BApa_ho_jAnA
samawala_ho	samawala_ho
sahI_ho	sahI_ho
aXika_ho	aXika
uwwama_ho	uwwama
aswiwva_ho	aswiwva
samApwa_ho	samApwa
bahuwa_prasanna_ho	bahuwa_prasanna
xeKane_yogya_na_ho	xeKane_yogya_na
sAmanA_ho	sAmanA
asaPala_ho	asaPala
samApwa_ho_jAnA/Kawma_hojA	samApwa_ho_jAnA/Kawma_hojAnA
anuwwIrNa_ho	anuwwIrNa
kamI_ho	kamI
aparyApwa_ho	aparyApwa
na_hone_para/ke_aBAva_meM	na_hone_para/ke_aBAva_meM
mUrCiwa_ho	mUrCiwa
pICe_ho	pICe
meM_ho_jA	meM_ho_jAnA
sahamawa_ho	sahamawa
kama_ho_jA	kama_ho_jAnA
asaPala_ho	asaPala
pariciwa_ho	pariciwa_ho
icCA_ho	icCA
awyaMwa_BayaBIwa_ho	awyaMwa_BayaBIwa
BayaBIwa_ho	BayaBIwa
apane_jIvana_kA_Baya_ho	apane_jIvana_kA_Baya
uwwejiwa_ho	uwwejiwa
baMXana_meM_ho	baMXana_meM
kadZuvAhata_ho	kadZuvAhata
awi_uwwejiwa_ho	awi_uwwejiwa
halkA_buKAra_ho	halkA_buKAra
aXika_uwwejanA_ho	aXika_uwwejanA
mahawvahIna_ho	mahawvahIna
Kela_ke_mExAna_meM_hone_vAlI_prawisparXAyeM	Kela_ke_mExAna_meM_hone_vAlI_prawisparXAyeM
samAXAna_ho	samAXAna_ho
yogya_ho	yogya
yogya_ho	yogya
BarA_huA_ho	BarA_huA
aBAva_ho	aBAva
viSvaswa_ho	viSvaswa
bahuwa_kama_anwara_ho	bahuwa_kama_anwara
jAnakArI_ho	jAnakArI
kaTinawA_se_prasanna_hone_vAlA	kaTinawA_se_prasanna_hone_vAlA
uwwejiwa_ho	uwwejiwa
jalxI_uwwejiwa_hone_vAlA	jalxI_uwwejiwa_hone_vAlA
sWirawA_ho	sWirawA
svasWa_ho	svasWa
asaPala_ho	asaPala
gEsa_kA_milA_ho	gEsa_kA_milA
kamajZora_ho	kamajZora
kroXiwa_ho	kroXiwa
acAnaka_kroXiwa_ho	acAnaka_kroXiwa
PElA_huA_ho	PElA_huA
KarAba_ho	KarAba
binA_GumAva_kA_ho	binA_GumAva_kA
awyaXika_pareSAna_ho	awyaXika_pareSAna
pEra_meM_GumAva_na_ho	pEra_meM_GumAva_na
asaPala_ho	asaPala
kadZakA_ho	kadZakA
bahuwa_WakA_ho	bahuwa_WakA
samawala_ho	samawala_ho
KuSa_ho	KuSa
rOSana_ho	rOSana_ho
peta_meM_gEsa_ho	peta_meM_gEsa
xoRayukwa_ho	xoRayukwa
niSciwa_samaya_na_ho	niSciwa_samaya_na
apane_kAma_meM_SreRTa_ho	apane_kAma_meM_SreRTa
meM_rawa_ho	meM_rawa_ho
Ananxiwa_ho	Ananxiwa
uwwejiwa_ho	uwwejiwa
kroXiwa_ho	kroXiwa
gamBIra_na_ho	gamBIra_na
gamBIra_na_ho	gamBIra_na
awi_uwsAhiwa_ho	awi_uwsAhiwa
bADZa_se_praBAviwa_hone_vAlI_jZamIna	bADZa_se_praBAviwa_hone_vAlI_jZamIna
klaba_yA_hotala_meM_praxarSana	klaba_yA_hotala_meM_praxarSana
asaPala_ho	asaPala
saPala_ho	saPala
svasWa_ho	svasWa
jZAhira_ho	jZAhira
jZAhira_ho	jZAhira
asaPala_ho	asaPala
hawapraBa_ho	hawapraBa_ho
acAnaka_ho	acAnaka
pUre_yOvana_para_ho	pUre_yOvana_para
saPala_ho	saPala
asvIkAra_ho	asvIkAra
asamBava_ho_jA	asamBava_ho_jAnA
AkrAmaka_ho	AkrAmaka
mqwyu_ho	mqwyu
mqwyu_ho	mqwyu
mqwyu_ho	mqwyu
AramBa_se_kAma_acCI_waraha_ho	AramBa_se_kAma_acCI_waraha
GodZI_kA_gABina_ho	GodZI_kA_gABina
GodZI_kA_baccA_pExA_ho	GodZI_kA_baccA_pExA
Pokasa_meM_ho	Pokasa_meM
keMxriwa_ho	keMxriwa
gola_hokara_leta	gola_hokara_letanA
Brama_pExA_ho	Brama_pExA
mAlUma_na_ho	mAlUma_na
mAlUma_na_ho	mAlUma_na
samApwa_ho	samApwa
Gatiwa_ho	Gatiwa
sabake_sAWa_ho	sabake_sAWa
CotA_parvawa_jo_badZe_parvawa_ke_AXAra_meM_ho	CotA_parvawa_jo_badZe_parvawa_ke_AXAra_meM_ho
lAgU_ho	lAgU
yanwra	yanwra
kabjA_kara_le	kabjA_kara_lenA
viBAjiwa_ho	viBAjiwa
EsI_ASA_jo_pUrI_na_ho_sake	EsI_ASA_jo_pUrI_na_ho_sake
asaPala_ho_jA	asaPala_ho_jAnA
cAroM_ora_ho	cAroM_ora
jo_PrAMsa_saByawA_pasaMxa_karawA_ho	jo_PrAMsa_saByawA_pasaMxa_karawA_ho
gUgula/cipacipA_paxArWa_jo_pUjA_meM_prayoga_howA_hE	gUgula/cipacipA_paxArWa_jo_pUjA_meM_prayoga_howA_hE
PrI_EMtaraprAijZa	PrI_EMtaraprAijZa
cAlU_ho	cAlU
jinameM_niyama_Ora_prawibanXa_kama_howe_hEM	jinameM_niyama_Ora_prawibanXa_kama_howe_hEM
wAjA_ho	wAjA
vyaWiwa_ho	vyaWiwa
saralawA_se_cU_cUra_hone_vAlA	saralawA_se_cU_cUra_hone_vAlA
aXika_TaMda_se_sunna_ho	aXika_TaMda_se_sunna
PUKiyA	PUKiyA
saMgIwa_raca	saMgIwa_racanA
bImArI_meM_jihvA_para_hone_vAlI_waha	bImArI_meM_jihvA_para_hone_vAlI_waha
xivAnA_ho	xivAnA
prApwa_ho	prApwa
gelerI_honA_yA_gelerI_jEsA	gelerI_honA_yA_gelerI_jEsA
piwwASya_meM_honevAlI_gAzTa	piwwASya_meM_honevAlI_gAzTa
pedZa_yA_JAdZI_jisake_saPexa_yA_pIle_PUla_howe_hEM	pedZa_yA_JAdZI_jisake_saPexa_yA_pIle_PUla_howe_hEM
niyukwa_ho	niyukwa
uganA/aMkuriwa_ho	uganA/aMkuriwa
saPala_ho	saPala
ekawra_ho	ekawra
CotA_sA_pOXA_jisameM_lAla_Ora_pIle_PUla_howe_hEM	CotA_sA_pOXA_jisameM_lAla_Ora_pIle_PUla_howe_hEM
vaha_puruRa_jo_vqxXa_swrI_para_ASriwa_howA_hE	vaha_puruRa_jo_vqxXa_swrI_para_ASriwa_howA_hE
Kawma_ho_jA	Kawma_ho_jAnA
banxa_ho_jAnA/javAba_xe_xe	banxa_ho_jAnA/javAba_xe_xenA
awi_camakaxAra_ho	awi_camakaxAra
AvAjZa_ho	AvAjZa_ho
prawikUla_ho	prawikUla
agrasara_ho	agrasara
Suru_ho	Suru
visPota_ho	visPota
naRta_ho_jA	naRta_ho_jAnA
ikatTA_ho	ikatTA
yuvawI_jo_kisI_prasixXa_saMgIwakAra_ke_pICe_pICe_GUmawI_ho	yuvawI_jo_kisI_prasixXa_saMgIwakAra_ke_pICe_pICe_GUmawI_ho
AXA_JukA_ho	AXA_JukA
hAWa_meM_ho	hAWa_meM
viSeRawOra_se_pasanxa_kiyA_ho	viSeRawOra_se_pasanxa_kiyA_ho
ulate_KadA_ho	ulate_KadA
lAlAyiwa_ho	lAlAyiwa
Gatiwa_ho	Gatiwa
xabAva_meM_jakadZA_ho	xabAva_meM_jakadZA
kadZA_ho_jA	kadZA_ho_jAnA
katA_hoMTa	katA_hoMTa
pAsa_ho	pAsa
svasWa_ho	svasWa
kisI_kI_musIbawa_meM_sahAyaka_ho	kisI_kI_musIbawa_meM_sahAyaka
JuNda_meM_ekawriwa_ho	JuNda_meM_ekawriwa
samAnavarwanI_Sabxa_jinake_arWa_Binna_ho	samAnavarwanI_Sabxa_jinake_arWa_Binna_ho
eka_kenxra_kA_xUsare_kenxra_se_judZA_ho	eka_kenxra_kA_xUsare_kenxra_se_judZA
kruxXa_ho_jA	kruxXa_ho_jAnA
sWAna_jahAz_vaswu_ko_KojA_jA_rahA_ho	sWAna_jahAz_vaswu_ko_KojA_jA_rahA_ho
cupa_ho_jA	cupa_ho_jAnA
eka_waraha_kA_cihna_jo_kisI_BAvanA_kA_prawIka_ho	eka_waraha_kA_cihna_jo_kisI_BAvanA_kA_prawIka_ho
wEyAra_na_ho	wEyAra_na
aMwaH_visPota_ho	aMwaH_visPota
kA_arWa_ho	kA_arWa
gaNiwa_meM_jisakA_mUla_jFAna_na_ho	gaNiwa_meM_jisakA_mUla_jFAna_na_ho
jisakA_Salya-cikiwsA_na_ho_sake	jisakA_Salya-cikiwsA_na_ho_sake
jo_wqpwa_na_ho	jo_wqpwa_na_ho
jo_alaga_na_ho_sake	jo_alaga_na_ho_sake
jo_samAja_ke_BIwara_ho	jo_samAja_ke_BIwara_ho
nimiwwa_ho	nimiwwa
aMwa:saMcAra_ho	aMwa:saMcAra
bIca_bIca_meM_ho	bIca_bIca_meM
sahajajFAna_ho	sahajajFAna
KujalI_ho	KujalI
KujalI_ho	KujalI
icCA_ho	icCA
kArAvAsa_ho	kArAvAsa
rAswA_pAra_karane_meM_lAparavAha_ho	rAswA_pAra_karane_meM_lAparavAha
SAmila_ho	SAmila
ekajuta_ho	ekajuta
KuSa_ho	KuSa
SurU_hone_kA_sWAna	SurU_hone_kA_sWAna
awirikwa_xOdZa	awirikwa_xOdZa
akasmAwa_cAlU_ho	akasmAwa_cAlU
jampa_sUta	jampa_sUta
jUniyara_kAleja	jUniyara_kAleja
wabiyawa_ho	wabiyawa
xUra_rahanA/na_ho	xUra_rahanA/na
sahasA_hone_vAlA_lABa	sahasA_hone_vAlA_lABa
Waka_kara_cUra_ho	Waka_kara_cUra
jFAwa_ho	jFAwa
acewa_ho	acewa
baccoM_ko_hone_vAlI_bImArI	baccoM_ko_hone_vAlI_bImArI
kamI_ho	kamI
lEMdiMga	lEMdiMga
kama_ho	kama
raxxa_ho_jA	raxxa_ho_jAnA
avanawa_ho_jA	avanawa_ho_jAnA
Age_ho	Age
prakata_ho_jA	prakata_ho_jAnA
nirBara_ho	nirBara
pravqwwi_ho	pravqwwi
GatanA/kama_ho	GatanA/kama
sWiwa_ho	sWiwa
sWiwi_meM_ho	sWiwi_meM
prakASiwa_ho	prakASiwa
gamBIrawA_rahiwa_hokara	gamBIrawA_rahiwa_hokara
cinwAmukwa_ho	cinwAmukwa
girjAGara_meM_hone_vAlI_viSeRa_prakAra_kI_pUjA	girjAGara_meM_hone_vAlI_viSeRa_prakAra_kI_pUjA
Gatiwa_howA_huA	Gatiwa_howA_huA
Gatiwa_hone_vAlI	Gatiwa_hone_vAlI
sajIva_ho	sajIva
nihiwa_arWa_ho	nihiwa_arWa
kArya_meM_pragawi_na_ho_pA	kArya_meM_pragawi_na_ho_pAnA
xiSA_kI_ora_ho	xiSA_kI_ora
samBAvanA_ho	samBAvanA
barabAxa_ho	barabAxa
pICe_ho_jA	pICe_ho_jAnA
beraMga_pAnI_jo_paSuoz_kI_nasoM_meM_howA_hE	beraMga_pAnI_jo_paSuoz_kI_nasoM_meM_howA_hE
pAgala_ho	pAgala_ho
saPala_ho	saPala
mAla	mAla
AxamI_kAma_para_ho	AxamI_kAma_para_ho
AScaryacakiwa_ho	AScaryacakiwa_ho
ekawra_ho	ekawra_ho
mahawvapUrNa_ho	mahawvapUrNa
koI_vyakwi_yA_vaswu_jisase_Bojana_kI_vyavasWA_ho	koI_vyakwi_yA_vaswu_jisase_Bojana_kI_vyavasWA_ho
arWa_ho	arWa
mawalaba_ho	mawalaba
mahawvapUrNa_ho	mahawvapUrNa
nApa_kA_ho	nApa_kA
camadZI_para_eka_gaharA_xAga	camadZI_para_eka_gaharA_xAga
mAsika_Xarma_kA_baMxa_ho_jA	mAsika_Xarma_kA_baMxa_ho_jAnA
mAikrocipa	mAikrocipa
hara_kAma_se_PAyaxA_ho	hara_kAma_se_PAyaxA
Apawwi_ho	Apawwi_ho
eka_tEksI_jo_pahale_se_waya_ho	eka_tEksI_jo_pahale_se_waya_ho
gaMxA_ho	gaMxA_ho
garBapAwa_ho	garBapAwa
galawa_nAma_ho	galawa_nAma
asaPala_ho	asaPala
mAwA_ho	mAwA
rAjA_yA_rAnI_ho	rAjA_yA_rAnI
Soka_karanA/xuHKI_ho	Soka_karanA/xuHKI
BAvuka_ho	BAvuka
kisI_waraha_saPala_ho	kisI_waraha_saPala
ekawriwa_ho	ekawriwa
jarUrawa_ho	jarUrawa
jo_gorA_na_ho	jo_gorA_na_ho
jahAz_mevA_bahuwAyAwa_ho	jahAz_mevA_bahuwAyAwa_ho
acarciwa_ho	acarciwa
aswiwva_meM_ho	aswiwva_meM
nimiwwamAwra_ho	nimiwwamAwra
jZarUrawa_ho	jZarUrawa
rAya_ho	rAya
AraMBa_honA_yA_kara	AraMBa_honA_yA
behawara_ho	behawara
se_badZA_ho_jA	se_badZA_ho_jAnA
se_aXika_sEnyaSakwi_ho	se_aXika_sEnyaSakwi
se_saMKyA_jyAxA_ho	se_saMKyA_jyAxA
se_behawara_ho	se_behawara
se_jyAxA_bikrI_ho	se_jyAxA_bikrI
mahawvapUrNa_sAbiwa_ho	mahawvapUrNa_sAbiwa
avaXi_bIwane_para_BI_jo_cukAyA_na_gayA_ho	avaXi_bIwane_para_BI_jo_cukAyA_na_gayA_ho
bAhara_latakA_ho	bAhara_latakA
sira_ke_Upara_se_hone_vAlA	sira_ke_Upara_se_hone_vAlA
awyaXika_prasanna_ho	awyaXika_prasanna
eka_hI_samaya_ho	eka_hI_samaya
jisameM_jarUrawa_se_jyAxA_karmacArI_Bare_hoM	jisameM_jarUrawa_se_jyAxA_karmacArI_Bare_hoM
aXika_ho	aXika
mahawva_meM_baDZa_caDZakara_ho	mahawva_meM_baDZa_caDZakara
qNI_ho	qNI
svAmI_ho	svAmI
nAma_aMkiwa_ho	nAma_aMkiwa
xarxa_ho	xarxa
svAxa_ho	svAxa
nIrasa_ho_jA	nIrasa_ho_jAnA
GabarAhata_ho	GabarAhata
eka_rAjya_kA_BUBAga_jo_xUsare_rAjya_meM_ho	eka_rAjya_kA_BUBAga_jo_xUsare_rAjya_meM_ho
sanwrAswa_ho	sanwrAswa
BAgIxAra_ho	BAgIxAra
uwwIrNa_ho	uwwIrNa
maMjZUra_ho	maMjZUra
lABakara_ho	lABakara
SAnwikAla	SAnwikAla
samBava_na_ho	samBava_na
kA_ho	kA
meM_vyApwa_ho	meM_vyApwa
XIre_XIre_samApwa_ho_jA	XIre_XIre_samApwa_ho_jAnA
aSmIkqwa_ho	aSmIkqwa
xurGatanA_jisameM_bahuwa_sArI_gAdiyAz_SAmila_ho	xurGatanA_jisameM_bahuwa_sArI_gAdiyAz_SAmila_ho
mIna_rASi_meM_pExA_hone_vAlA_manuRya	mIna_rASi_meM_pExA_hone_vAlA_manuRya
kampyUtara_para_prakata_hone_vAle_Sabxabinxu	kampyUtara_para_prakata_hone_vAle_Sabxabinxu
Kelane_ke_lie_sahamawa_ho	Kelane_ke_lie_sahamawa
kI_ora_ho	kI_ora
pariRkqwa_honA/saMvArA_jA	pariRkqwa_honA/saMvArA_jAnA
raMgo_ke_liye_prayukwa_honevAlA_plAstika	raMgo_ke_liye_prayukwa_honevAlA_plAstika
kA_svAmI_yA_mAlika_ho	kA_svAmI_yA_mAlika
se_sampanna_ho	se_sampanna
saMBava_ho_saka	saMBava_ho_sakanA
pravAhiwa_ho	pravAhiwa
samarWa_ho	samarWa_ho
se_pahale_AnA_yA_Gatiwa_ho	se_pahale_AnA_yA_Gatiwa
se_pahale_Gatiwa_ho	se_pahale_Gatiwa
prabala_ho	prabala
sarvAXika_ho	sarvAXika
pahale_se_ho	pahale_se
prAraMBa_honA_yA_kara	prAraMBa_honA_yA
pUrvasUcanA_xenA/pUrvaboXa_ho	pUrvasUcanA_xenA/pUrvaboXa
xabAva_meM_ho	xabAva_meM_ho
ke_liye_AvaSyaka_ho	ke_liye_AvaSyaka
pracaliwa_ho	pracaliwa
agresara_ho	agresara
bahirviRta_ho	bahirviRta
pracura_mAwrA_meM_uwpanna_honA_yA_kara	pracura_mAwrA_meM_uwpanna_honA_yA
samqxXa_ho	samqxXa_ho
saPala_ho	saPala
bAhara_nikalA_huA_honA_yA_nikAla	bAhara_nikalA_huA_honA_yA_nikAlanA
vaha_vyakwi_jise_ladanA_pasanxa_ho	vaha_vyakwi_jise_ladanA_pasanxa_ho
saPala_ho_jA	saPala_ho_jAnA
TIka_ho_jA	TIka_ho_jAnA
kampAyamAna_ho	kampAyamAna
paMca_kArda	paMca_kArda
cOgunA_karanA_yA_ho	cOgunA_karanA_yA_ho
barAbara_ho	barAbara
rebIjZa	rebIjZa
kisI_kenxrIya_binxu_se_cAroM_ora_prasPutiwa_ho	kisI_kenxrIya_binxu_se_cAroM_ora_prasPutiwa
vikiraNaSIla_kiraNoM_ke_praBAva_se_hone_vAlA_roga	vikiraNaSIla_kiraNoM_ke_praBAva_se_hone_vAlA_roga
jisame_rediyo_sakrIyawA_ho	jisame_rediyo_sakrIyawA_ho
varRA_ho	varRA
prasanna_ho	prasanna
Age_kI_ora_DZAlU_ho	Age_kI_ora_DZAlU
paxa_me_UzcA_ho	paxa_me_UzcA
paxa_me_UzcA_ho	paxa_me_UzcA
kama_GanA_honA/pawalA_karanA_yA_ho	kama_GanA_honA/pawalA_karanA_yA
upahAsa_me_jIBa_Ora_hoMToM_se_nikAlI_gayI_AvAja	upahAsa_me_jIBa_Ora_hoMToM_se_nikAlI_gayI_AvAja
kroXiwa_hokara_bAwa_kara	kroXiwa_hokara_bAwa
PElA_ho	PElA
pawA_calanA/boXa_ho	pawA_calanA/boXa
piCale_pEra_para_KadZe_ho	piCale_pEra_para_KadZe
nirBara_ho	nirBara
TIka_ho	TIka
punaH_svasWa_ho	punaH_svasWa
kroXa_me_Ape_se_bAhara_ho_jA	kroXa_me_Ape_se_bAhara_ho_jAnA
lAla_karanA_yA_ho	lAla_karanA_yA
xuHKI_ho	xuHKI
prabala_ho	prabala
mOjUxa_ho	mOjUxa
prasanna_karanA_yA_ho	prasanna_karanA_yA
Pira_se_sammiliwa_ho	Pira_se_sammiliwa
sambaxXa_ho	sambaxXa
wanAva_mukwa_ho	wanAva_mukwa_ho
punaH_savAra_ho	punaH_savAra
hatAva_yA_xUra_hone_kI_kriyA	hatAva_yA_xUra_hone_kI_kriyA
bexara_ho_jA	bexara_ho_jAnA
manoraMjana_hewu_viSeRa_sWAna_meM_ikatTA_ho	manoraMjana_hewu_viSeRa_sWAna_meM_ikatTA
jisakA_navInakaraNa_samBava_ho	jisakA_navInakaraNa_samBava_ho
prawiniXi_ho	prawiniXi
uxAharaNa_ke_rUpa_me_ho	uxAharaNa_ke_rUpa_me
prasixXa_ho	prasixXa
saxqSa_ho	saxqSa
ArakRiwa_ho	ArakRiwa
anuwwIrNa_hone_para_punaH_parIkRA_xe	anuwwIrNa_hone_para_punaH_parIkRA_xenA
guMjiwa_ho	guMjiwa
prawiXvaniwa_ho	prawiXvaniwa
kisI_kAma__ke_liye_jimmexAra_ho	kisI_kAma__ke_liye_jimmexAra
Pira_uTa_KadZA_hone_vAlA	Pira_uTa_KadZA_hone_vAlA
vApasa_ho	vApasa
kImawa_kama_ho	kImawa_kama
rAjaxrohI_ho	rAjaxrohI
piswOla	piswOla
poSAka_me_lage_Cote-Cote_PIwe	poSAka_me_lage_Cote-Cote_PIwe
sEra	sEra
uxiwa_ho	uxiwa
wIvra_ho	wIvra
prasanna_ho_jA	prasanna_ho_jAnA
rOYbina	rOYbina
ravAnA_ho	ravAnA
jahAjZa_ke_lie_prayukwa_hone_vAlA_motA_kapadZA	jahAjZa_ke_lie_prayukwa_hone_vAlA_motA_kapadZA
aSakwa_yA_xurbala_ho	aSakwa_yA_xurbala
BarA_ho	BarA
vijayI_ho	vijayI
miwavyayI_ho	miwavyayI
jodZane_ke_lie_prayukwa_hone_vAlA_paxArWa	jodZane_ke_lie_prayukwa_hone_vAlA_paxArWa
surakRA_ke_lie_prayukwa_hone_vAlA_paxArWa	surakRA_ke_lie_prayukwa_hone_vAlA_paxArWa
ke_lie_jagaha_ho	ke_lie_jagaha
alaga_ho	alaga
prawIwa_honA/laganA/jAna_padZa	prawIwa_honA/laganA/jAna_padZanA
awi_kupiwa_ho	awi_kupiwa
CalanI_ho	CalanI
alaga_ho	alaga_ho
ke_lie_paryApwa_ho	ke_lie_paryApwa
xqDZa_ho_jA	xqDZa_ho_jAnA
kaTora_ho_jA	kaTora_ho_jAnA
1aswa_ho_jA	1aswa_ho_jAnA
wEyAra_ho	wEyAra
SAnwa_ho_jA	SAnwa_ho_jAnA
SarAba_jisa_meM_nIbU_yA_axaraka_milA_ho	SarAba_jisa_meM_nIbU_yA_axaraka_milA_ho
tukadZe_tukadZe_kara_xenA_yA_ho_jA	tukadZe_tukadZe_kara_xenA_yA_ho_jAnA
naRta_karanA_yA_ho_jA	naRta_karanA_yA_ho_jAnA
Cinna_Binna_karanA_yA_ho_jA	Cinna_Binna_karanA_yA_ho_jAnA
AGAwa_se_praBAviwa_na_hone_vAlA	AGAwa_se_praBAviwa_na_hone_vAlA
halkI_barasAwa_meM_gIlA_na_hone_vAlA	halkI_barasAwa_meM_gIlA_na_hone_vAlA
judZavA_bacce_jo_Apasa_meM_judZe_ho	judZavA_bacce_jo_Apasa_meM_judZe_ho
cAkaleta_sigareta_iwyAxi_ko_lapatane_keliye_upayukwa_honevAlA_camakaxAra_kAgajZa	cAkaleta_sigareta_iwyAxi_ko_lapatane_keliye_upayukwa_honevAlA_camakaxAra_kAgajZa
AlasI_ho	AlasI
saBA_meM_SAmila_ho	saBA_meM_SAmila
miwavyayI_ho	miwavyayI
bekAbU_ho_jAnA/BadZakEla	bekAbU_ho_jAnA/BadZakEla
unIMxA_hokara	unIMxA_hokara
sWAnaBraMSa_ho	sWAnaBraMSa
DAlU_ho	DAlU_ho
Baxxepana_se_calanA/KadZe_honA_yA_bETa	Baxxepana_se_calanA/KadZe_honA_yA_bETanA
smeliMga_sAlta/behoSa_vyakwi_ko_hoSa_meM_lAne_keliye_viSeRa_kemikala	smeliMga_sAlta/behoSa_vyakwi_ko_hoSa_meM_lAne_keliye_viSeRa_kemikala
vaha_kAraNa_jo_pawA_na_ho	vaha_kAraNa_jo_pawA_na_ho
xuHKI_ho	xuHKI
jisakI_eka_KAsa_Xvani_ho	jisakI_eka_KAsa_Xvani_ho
uwsAha_se_BarA_ho	uwsAha_se_BarA
XErya_evaM_vIrawA_Axi_guNoM_kA_honA/sAxA_Ora_kaTora	XErya_evaM_vIrawA_Axi_guNoM_kA_honA/sAxA_Ora_kaTora
viBAjiwa_ho	viBAjiwa_ho
jIvANu_jo_baDZakara_eka_nayA_prANI_ho_jAwA_hE	jIvANu_jo_baDZakara_eka_nayA_prANI_ho_jAwA_hE
aMkuriwa_ho	aMkuriwa
narama_lakadZI_jo_pepara_banAne_meM_iswemAla_howI_hE	narama_lakadZI_jo_pepara_banAne_meM_iswemAla_howI_hE
uwwejiwa_ho_kara_bola	uwwejiwa_ho_kara_bolanA
niRkriya_ho	niRkriya
prakopiwa_ho	prakopiwa
iMjana_kA_banxa_ho_jA	iMjana_kA_banxa_ho_jAnA
liPZAPZA_jisa_para_pawA_Ora_tikata_ho	liPZAPZA_jisa_para_pawA_Ora_tikata_ho
vyakwi_kI_avasWA	vyakwi_kI_avasWA
KadZA_ho	KadZA_ho
KadZA_ho	KadZA_ho
kisI_BI_xeSa_kA_nAgarika_na_ho	kisI_BI_xeSa_kA_nAgarika_na
sWiwa_ho	sWiwa
pareSAna_ho	pareSAna
kadZA_ho	kadZA
jisake_Age_vikAsa_na_ho	jisake_Age_vikAsa_na_ho
bAzsa_jisa_para_Gara_sWira_ho	bAzsa_jisa_para_Gara_sWira_ho
xarxa_ho	xarxa
se_alaga_ho_jA	se_alaga_ho_jAnA
PaMsa_jAnA[=>asahAya_honA]	PaMsa_jAnA[=>asahAya_honA]
ekawra_honA/parawoM_kA_AkAra_le	ekawra_honA/parawoM_kA_AkAra_lenA
cakiwa_ho	cakiwa
kama_ho	kama
kama_ho_jA	kama_ho_jAnA
parAswa_ho	parAswa
paryApwa_ho	paryApwa
suviXAjanaka_ho	suviXAjanaka
anukUla_ho	anukUla
alaga_ho	alaga
aXinovA	aXinovA
OMsanA/umasa_ho	OMsanA/umasa
apane_Apa_banxa_hone_vAlA_xarvAjZA	apane_Apa_banxa_hone_vAlA_xarvAjZA
jAgarUka_ho	jAgarUka
behoSa_ho_jA	behoSa_ho_jAnA
se_sahamawa_ho	se_sahamawa
samakAlika_ho	samakAlika
vaSa_meM_ho	vaSa_meM
waMga_ho	waMga
tepestrI	tepestrI
malina_ho	malina
aSAnwipUrNa_ho	aSAnwipUrNa
cAya_kA_hotala	cAya_kA_hotala
BarA_ho	BarA
telIPona_puswikA	telIPona_puswikA
kirAye_para_ho	kirAye_para
pravqwwa_ho	pravqwwa
sAkRI_ho	sAkRI_ho
gADZA_ho	gADZA
cikanA_GadZA	cikanA_GadZA
pawalA_ho	pawalA
wqRiwa_ho	wqRiwa
samqxXa_ho	samqxXa
meM_ho	meM
jisako_guxaguxI_aXika_lagawI_ho	jisako_guxaguxI_aXika_lagawI_ho
se_sambaxXa_ho	se_sambaxXa
Kela_meM_barAbara_ho	Kela_meM_barAbara
SarAbI_ho	SarAbI
pEra_ke_azgUTe_para_ho	pEra_ke_azgUTe_para
manxa_ho	manxa
se_pUrA_mela_ho	se_pUrA_mela
praBAviwa_ho	praBAviwa
UzcA_ho	UzcA
aXika_UzcA_ho	aXika_UzcA
se_baDakara_ho	se_baDakara
banAvatI_vaswu	banAvatI_vaswu
kisI_kI_AvAja_kA_XIre_XIre_kama_ho	kisI_kI_AvAja_kA_XIre_XIre_kama
banXana_ho	banXana_ho
trEmpolIna	trEmpolIna
se_baDakara_ho	se_baDakara
nukIlI_vaswu_yukwa_ho	nukIlI_vaswu_yukwa
swamBiwa_ho	swamBiwa
Gatiwa_ho	Gatiwa
aBiBUwa_ho	aBiBUwa
kisI_vaswu_ke_Upara_hokara_cala	kisI_vaswu_ke_Upara_hokara_calanA
KajA	KajAnA
wala_jisake_Upara_peda_na_ugawA_ho	wala_jisake_Upara_peda_na_ugawA_ho
vAxya_yanwra_jisameM_lohe_kI_CadI_wrikoNa_rUpa_kA_moda_ho	vAxya_yanwra_jisameM_lohe_kI_CadI_wrikoNa_rUpa_kA_moda_ho
uwwejiwa_ho	uwwejiwa_ho
racanAwraya	racanAwraya
bede_jEsI_nAva_jisameM_wIna_samAnwara_pete_ho	bede_jEsI_nAva_jisameM_wIna_samAnwara_pete_ho
kExI	kExI
SarIra_ke_KoKalA_avayava_jo_nalAkAra_ho	SarIra_ke_KoKalA_avayava_jo_nalAkAra_ho
sarvanASa_ho	sarvanASa
kAztexAra_JAdZI	kAztexAra_JAdZI
ke_anukUla_ho	ke_anukUla
jisakA_saMBava_waWA_viparIwArWa_ho	jisakA_saMBava_waWA_viparIwArWa_ho
kA_prawIka_ho	kA_prawIka
jisakA_koI_xAvexAra_na_ho	jisakA_koI_xAvexAra_na_ho
aXika_cIje_na_ho	aXika_cIje_na
BarA_huA_na_ho	BarA_huA_na
naRta_na_honevAlA	naRta_na_honevAlA
jisakI_apekRA_na_ho	jisakI_apekRA_na_ho
jisase_inkAra_na_ho	jisase_inkAra_na_ho
asaPala_ho	asaPala
jisame_rukAvata_na_huA_ho	jisame_rukAvata_na_huA_ho
jiname_axIkRiwA_ho	jiname_axIkRiwA_ho
eka_ho_jA	eka_ho_jAnA
eka_ke_bAxa_eka_ho	eka_ke_bAxa_eka
niRPala_ho	niRPala
jisame_miTAsa_na_ho	jisame_miTAsa_na_ho
SAMwa_ho_jA	SAMwa_ho_jAnA
cinwiwa_na_ho	cinwiwa_na
rAjya_kA_vaha_BAga_jo_muKya_Sahara_se_xUra_ho	rAjya_kA_vaha_BAga_jo_muKya_Sahara_se_xUra_ho
mola_ho	mola_ho
sixXAnwa_jinameM_samAja_kI_viSeRa_AsWA_ho	sixXAnwa_jinameM_samAja_kI_viSeRa_AsWA_ho
lupwa_ho	lupwa
vaha_binxu_jahAz_samAnAnwara_reKAez_milawI_prawIwa_ho	vaha_binxu_jahAz_samAnAnwara_reKAez_milawI_prawIwa_ho
waraha_waraha_kA_ho	waraha_waraha_kA
Binna_ho	Binna
cinwiwa_ho	cinwiwa
spaMxiwa_ho	spaMxiwa
nyAya_sixXa_ho	nyAya_sixXa_ho
pracalana_meM_ho	pracalana_meM
BAva_ho	BAva
XIre_XIre_samApwa_ho	XIre_XIre_samApwa
vajana_ho	vajana
viSeRa_rUpa_se_praBAviwa_ho	viSeRa_rUpa_se_praBAviwa
upasWiwa_hone_ke_lie_liKiwa_AxeSa	upasWiwa_hone_ke_lie_liKiwa_AxeSa
GatanAoM_kA_wAzwA	GatanAoM_kA_wAzwA
pahuzca_ke_bAhara_ho	pahuzca_ke_bAhara_ho
cOdA_ho	cOdA_ho
icCA_ho	icCA_ho
kRINa_ho	kRINa
acaraja_ho	acaraja_ho
kOwuka_ho	kOwuka
ciMwiwa_ho	ciMwiwa
Ora_burA_ho	Ora_burA
naRta_ho	naRta
aXIna_ho	aXIna_honA
